instance,solver,start_vertex,cost_first,cost_second,total_cost,duration,max_candidates
kroA200.tsp,greedy-cycle,196,20645,17365,38010,2,15
kroB200.tsp,candidate-ls,150,19241,20756,39997,1661,15
kroA200.tsp,steepest-ls,166,19264,19008,38272,5605,15
kroB200.tsp,greedy-cycle,78,18048,20656,38704,2,15
kroB200.tsp,candidate-ls,30,18639,19347,37986,1510,15
kroB200.tsp,qc-ls,136,18610,19489,38099,802,15
kroA200.tsp,queue-ls,86,20595,18205,38800,877,15
kroA200.tsp,candidate-ls,40,20796,19330,40126,1529,15
kroB200.tsp,queue-ls,164,17764,19832,37596,859,15
kroB200.tsp,qc-ls,24,20818,20481,41299,825,15
kroA200.tsp,steepest-ls,70,18350,20744,39094,4585,15
kroB200.tsp,steepest-ls,116,17289,18989,36278,5085,15
kroB200.tsp,candidate-ls,88,20045,19190,39235,1436,15
kroB200.tsp,greedy-cycle,170,17780,20396,38176,2,15
kroA200.tsp,candidate-ls,56,18035,20357,38392,1516,15
kroA200.tsp,queue-ls,90,17665,19762,37427,830,15
kroA200.tsp,greedy-cycle,138,17534,21403,38937,2,15
kroB200.tsp,steepest-ls,100,19179,19423,38602,4890,15
kroA200.tsp,steepest-ls,66,20653,17931,38584,4930,15
kroB200.tsp,qc-ls,32,19178,18835,38013,875,15
kroB200.tsp,queue-ls,172,18949,19136,38085,815,15
kroB200.tsp,qc-ls,198,19672,18804,38476,786,15
kroA200.tsp,qc-ls,10,18107,19660,37767,813,15
kroB200.tsp,greedy-cycle,166,20210,18102,38312,3,15
kroB200.tsp,candidate-ls,146,19454,18515,37969,1490,15
kroA200.tsp,greedy-cycle,180,18327,19625,37952,2,15
kroA200.tsp,queue-ls,28,18777,18109,36886,843,15
kroA200.tsp,candidate-ls,118,20922,18438,39360,1540,15
kroA200.tsp,steepest-ls,170,19683,20039,39722,5288,15
kroB200.tsp,qc-ls,120,19067,18185,37252,840,15
kroB200.tsp,qc-ls,4,18501,19770,38271,869,15
kroB200.tsp,candidate-ls,26,19924,19706,39630,1442,15
kroA200.tsp,greedy-cycle,32,20645,17365,38010,2,15
kroA200.tsp,greedy-cycle,114,17362,18993,36355,2,15
kroB200.tsp,steepest-ls,26,18574,21817,40391,5031,15
kroA200.tsp,queue-ls,130,20122,18273,38395,971,15
kroA200.tsp,queue-ls,2,18867,19668,38535,840,15
kroB200.tsp,queue-ls,24,18992,18371,37363,916,15
kroB200.tsp,steepest-ls,194,21543,19738,41281,5611,15
kroA200.tsp,qc-ls,170,21219,20440,41659,814,15
kroB200.tsp,greedy-cycle,42,17864,20246,38110,2,15
kroA200.tsp,qc-ls,84,18729,20402,39131,846,15
kroA200.tsp,queue-ls,188,20122,19093,39215,834,15
kroA200.tsp,candidate-ls,134,19790,19008,38798,1587,15
kroB200.tsp,queue-ls,32,19490,20818,40308,822,15
kroA200.tsp,queue-ls,12,19202,19705,38907,853,15
kroB200.tsp,steepest-ls,182,18556,18189,36745,5341,15
kroA200.tsp,candidate-ls,122,19680,19000,38680,1474,15
kroA200.tsp,qc-ls,92,18439,21240,39679,812,15
kroB200.tsp,greedy-cycle,54,17786,20396,38182,3,15
kroB200.tsp,steepest-ls,88,19092,20295,39387,5077,15
kroA200.tsp,qc-ls,166,17982,19457,37439,766,15
kroA200.tsp,greedy-cycle,24,16943,20139,37082,2,15
kroB200.tsp,queue-ls,148,20710,18261,38971,864,15
kroA200.tsp,greedy-cycle,102,17061,20167,37228,2,15
kroA200.tsp,queue-ls,126,18142,19738,37880,859,15
kroB200.tsp,steepest-ls,30,21224,19119,40343,5234,15
kroA200.tsp,candidate-ls,102,20661,19106,39767,1671,15
kroB200.tsp,greedy-cycle,74,17206,20759,37965,2,15
kroA200.tsp,qc-ls,146,20962,18432,39394,764,15
kroB200.tsp,qc-ls,90,20129,18117,38246,877,15
kroB200.tsp,queue-ls,12,19211,19650,38861,817,15
kroA200.tsp,queue-ls,32,17664,19257,36921,800,15
kroB200.tsp,qc-ls,182,19024,20498,39522,817,15
kroB200.tsp,candidate-ls,84,19044,19363,38407,1562,15
kroA200.tsp,queue-ls,106,18635,21169,39804,901,15
kroB200.tsp,steepest-ls,10,19173,18636,37809,5418,15
kroA200.tsp,greedy-cycle,122,18444,18709,37153,2,15
kroB200.tsp,qc-ls,28,17714,19339,37053,800,15
kroB200.tsp,queue-ls,168,19468,19892,39360,833,15
kroB200.tsp,candidate-ls,92,18406,20368,38774,1486,15
kroB200.tsp,qc-ls,194,19998,18224,38222,861,15
kroA200.tsp,queue-ls,110,18694,20078,38772,826,15
kroA200.tsp,greedy-cycle,134,16614,21633,38247,2,15
kroA200.tsp,greedy-cycle,12,16626,21633,38259,2,15
kroA200.tsp,qc-ls,150,19508,18652,38160,823,15
kroB200.tsp,greedy-cycle,62,21486,18065,39551,2,15
kroB200.tsp,queue-ls,200,20167,19607,39774,882,15
kroA200.tsp,candidate-ls,114,21418,18989,40407,1490,15
kroB200.tsp,qc-ls,8,20421,20364,40785,794,15
kroB200.tsp,qc-ls,86,17961,19751,37712,806,15
kroA200.tsp,queue-ls,24,19168,19377,38545,830,15
kroA200.tsp,candidate-ls,180,18688,20228,38916,1608,15
kroA200.tsp,qc-ls,30,21079,18854,39933,799,15
kroB200.tsp,greedy-cycle,146,21600,18649,40249,3,15
kroA200.tsp,steepest-ls,2,19869,19082,38951,5642,15
kroA200.tsp,greedy-cycle,2,18893,20745,39638,2,15
kroB200.tsp,steepest-ls,120,19473,19647,39120,5264,15
kroA200.tsp,steepest-ls,46,18989,19881,38870,5333,15
kroB200.tsp,qc-ls,12,19876,20592,40468,786,15
kroB200.tsp,queue-ls,152,19572,19643,39215,886,15
kroA200.tsp,candidate-ls,76,19207,17411,36618,1506,15
kroB200.tsp,queue-ls,90,20400,19364,39764,813,15
kroA200.tsp,greedy-cycle,118,21703,18093,39796,3,15
kroB200.tsp,qc-ls,100,21369,17649,39018,809,15
kroA200.tsp,candidate-ls,138,19388,19714,39102,1515,15
kroA200.tsp,queue-ls,184,19705,19005,38710,839,15
kroA200.tsp,qc-ls,88,19928,21222,41150,836,15
kroB200.tsp,steepest-ls,92,19626,19791,39417,5028,15
kroA200.tsp,steepest-ls,150,18333,20186,38519,5377,15
kroB200.tsp,candidate-ls,166,19773,19095,38868,1448,15
kroB200.tsp,queue-ls,28,20684,19326,40010,817,15
kroB200.tsp,steepest-ls,198,18073,20950,39023,5353,15
kroA200.tsp,greedy-cycle,86,21218,17365,38583,2,15
kroB200.tsp,candidate-ls,10,17837,18602,36439,1625,15
kroB200.tsp,qc-ls,116,18331,20860,39191,829,15
kroA200.tsp,steepest-ls,146,19129,19299,38428,4942,15
kroB200.tsp,steepest-ls,84,18273,19428,37701,5356,15
kroB200.tsp,greedy-cycle,58,20210,18102,38312,2,15
kroA200.tsp,queue-ls,192,19372,20034,39406,881,15
kroB200.tsp,candidate-ls,170,19526,18943,38469,1553,15
kroA200.tsp,greedy-cycle,90,17669,22204,39873,2,15
kroB200.tsp,greedy-cycle,150,17606,20396,38002,2,15
kroA200.tsp,qc-ls,26,19596,21240,40836,778,15
kroA200.tsp,candidate-ls,196,18810,19670,38480,1521,15
kroB200.tsp,queue-ls,144,20359,20051,40410,802,15
kroA200.tsp,greedy-cycle,28,18068,17472,35540,2,15
kroA200.tsp,steepest-ls,50,19757,19810,39567,5436,15
kroB200.tsp,steepest-ls,136,20514,18550,39064,5092,15
kroB200.tsp,queue-ls,86,20006,19578,39584,871,15
kroA200.tsp,candidate-ls,60,16924,19894,36818,1480,15
kroB200.tsp,candidate-ls,126,21419,20187,41606,1420,15
kroB200.tsp,queue-ls,68,19299,19863,39162,879,15
kroA200.tsp,queue-ls,48,19195,19276,38471,862,15
kroB200.tsp,qc-ls,140,19074,20071,39145,792,15
kroB200.tsp,candidate-ls,46,18973,19790,38763,1435,15
kroA200.tsp,candidate-ls,178,19169,19762,38931,1446,15
kroA200.tsp,steepest-ls,110,20319,18697,39016,5007,15
kroB200.tsp,steepest-ls,160,18018,19204,37222,5237,15
kroB200.tsp,qc-ls,52,19322,19213,38535,816,15
kroB200.tsp,queue-ls,112,18243,20599,38842,787,15
kroA200.tsp,candidate-ls,36,21367,20077,41444,1436,15
kroA200.tsp,greedy-cycle,158,17924,17472,35396,2,15
kroA200.tsp,qc-ls,70,19210,19129,38339,845,15
kroB200.tsp,greedy-cycle,106,20263,18102,38365,2,15
kroA200.tsp,qc-ls,184,19300,20658,39958,846,15
kroB200.tsp,queue-ls,104,19553,20417,39970,886,15
kroA200.tsp,greedy-cycle,68,21416,18093,39509,6,15
kroB200.tsp,qc-ls,44,19284,19083,38367,809,15
kroA200.tsp,steepest-ls,10,20248,18585,38833,4957,15
kroB200.tsp,steepest-ls,176,17419,20530,37949,4897,15
kroA200.tsp,candidate-ls,20,19909,20122,40031,1410,15
kroB200.tsp,candidate-ls,188,18976,20133,39109,1457,15
kroA200.tsp,qc-ls,192,18790,19231,38021,800,15
kroB200.tsp,greedy-cycle,110,18658,21333,39991,2,15
kroA200.tsp,qc-ls,66,20315,17809,38124,821,15
kroA200.tsp,candidate-ls,98,19644,18916,38560,1430,15
kroB200.tsp,candidate-ls,130,20741,18900,39641,1435,15
kroB200.tsp,candidate-ls,50,19820,19961,39781,1469,15
kroB200.tsp,qc-ls,156,20259,19103,39362,850,15
kroA200.tsp,steepest-ls,106,21085,19444,40529,5117,15
kroB200.tsp,greedy-cycle,18,17685,20396,38081,2,15
kroA200.tsp,greedy-cycle,162,18206,17472,35678,2,15
kroB200.tsp,qc-ls,68,20223,19441,39664,850,15
kroA200.tsp,greedy-cycle,44,20726,17365,38091,3,15
kroB200.tsp,queue-ls,128,19419,18272,37691,858,15
kroA200.tsp,queue-ls,146,19511,19321,38832,827,15
kroB200.tsp,steepest-ls,50,17814,19653,37467,5084,15
kroA200.tsp,steepest-ls,192,19056,20099,39155,5078,15
kroA200.tsp,steepest-ls,84,20400,18575,38975,5429,15
kroB200.tsp,queue-ls,190,18922,19849,38771,849,15
kroB200.tsp,queue-ls,52,18938,19676,38614,837,15
kroA200.tsp,queue-ls,72,18812,20558,39370,819,15
kroA200.tsp,candidate-ls,142,17550,18918,36468,1680,15
kroB200.tsp,greedy-cycle,34,18713,20519,39232,2,15
kroA200.tsp,qc-ls,106,18413,19409,37822,801,15
kroB200.tsp,greedy-cycle,184,17825,20246,38071,2,15
kroB200.tsp,queue-ls,186,18259,20554,38813,860,15
kroA200.tsp,steepest-ls,92,20109,18814,38923,5310,15
kroA200.tsp,queue-ls,64,18990,19032,38022,840,15
kroB200.tsp,queue-ls,44,20085,18304,38389,927,15
kroB200.tsp,greedy-cycle,192,17786,20396,38182,2,15
kroA200.tsp,qc-ls,110,21346,18408,39754,771,15
kroB200.tsp,greedy-cycle,22,17780,20396,38176,4,15
kroA200.tsp,candidate-ls,154,18541,21701,40242,1622,15
kroB200.tsp,greedy-cycle,2,20595,18141,38736,2,15
kroA200.tsp,greedy-cycle,174,21703,18093,39796,2,15
kroA200.tsp,greedy-cycle,52,17362,18993,36355,3,15
kroA200.tsp,steepest-ls,184,18473,18618,37091,5072,15
kroB200.tsp,steepest-ls,46,18674,19431,38105,5232,15
kroA200.tsp,queue-ls,150,18731,21748,40479,839,15
kroA200.tsp,qc-ls,130,19059,21078,40137,830,15
kroA200.tsp,candidate-ls,174,19521,18043,37564,1501,15
kroA200.tsp,queue-ls,44,20625,20995,41620,817,15
kroB200.tsp,queue-ls,64,19465,19703,39168,845,15
kroA200.tsp,candidate-ls,82,20126,17988,38114,1609,15
kroA200.tsp,qc-ls,188,18341,20137,38478,867,15
kroB200.tsp,steepest-ls,66,20169,18707,38876,5106,15
kroA200.tsp,queue-ls,170,19464,19545,39009,876,15
kroA200.tsp,greedy-cycle,72,18893,20745,39638,3,15
kroB200.tsp,queue-ls,2,20213,19301,39514,805,15
kroA200.tsp,greedy-cycle,154,16595,22671,39266,2,15
kroB200.tsp,candidate-ls,192,18696,19380,38076,1741,15
kroA200.tsp,queue-ls,166,18969,19575,38544,871,15
kroB200.tsp,steepest-ls,70,20247,19519,39766,5244,15
kroB200.tsp,qc-ls,48,20207,19109,39316,864,15
kroA200.tsp,greedy-cycle,64,16819,21633,38452,3,15
kroB200.tsp,queue-ls,108,18029,20589,38618,852,15
kroB200.tsp,candidate-ls,184,18929,21909,40838,1380,15
kroA200.tsp,greedy-cycle,142,16943,20139,37082,3,15
kroA200.tsp,candidate-ls,162,19036,19416,38452,1584,15
kroB200.tsp,greedy-cycle,14,21600,18649,40249,3,15
kroA200.tsp,qc-ls,126,19403,19641,39044,844,15
kroA200.tsp,candidate-ls,94,20750,19104,39854,1491,15
kroB200.tsp,queue-ls,72,18290,21024,39314,875,15
kroA200.tsp,queue-ls,52,21299,18821,40120,855,15
kroB200.tsp,greedy-cycle,130,18113,20453,38566,3,15
kroA200.tsp,qc-ls,46,18652,18902,37554,845,15
kroB200.tsp,greedy-cycle,80,18048,20656,38704,2,15
kroB200.tsp,queue-ls,124,17943,18847,36790,820,15
kroA200.tsp,greedy-cycle,48,18068,17472,35540,4,15
kroB200.tsp,qc-ls,64,20683,19963,40646,830,15
kroA200.tsp,steepest-ls,30,20181,19148,39329,5398,15
kroB200.tsp,steepest-ls,156,18350,18813,37163,5121,15
kroB200.tsp,greedy-cycle,188,18253,21333,39586,2,15
kroA200.tsp,steepest-ls,126,19267,19040,38307,5025,15
kroB200.tsp,greedy-cycle,38,18256,21333,39589,2,15
kroB200.tsp,steepest-ls,6,20417,18545,38962,5312,15
kroB200.tsp,candidate-ls,70,19373,19388,38761,1551,15
kroB200.tsp,qc-ls,176,19508,17866,37374,846,15
kroA200.tsp,steepest-ls,88,18310,20567,38877,5084,15
kroB200.tsp,candidate-ls,110,18279,19989,38268,1534,15
kroA200.tsp,candidate-ls,158,19241,18522,37763,1551,15
kroA200.tsp,steepest-ls,130,19232,17367,36599,5213,15
kroB200.tsp,qc-ls,160,18175,18812,36987,817,15
kroB200.tsp,candidate-ls,66,19338,19008,38346,1531,15
kroB200.tsp,candidate-ls,106,18334,20317,38651,1560,15
kroB200.tsp,queue-ls,48,18805,19222,38027,879,15
kroA200.tsp,queue-ls,68,20859,18000,38859,825,15
kroB200.tsp,greedy-cycle,96,20595,18141,38736,4,15
kroA200.tsp,qc-ls,50,19427,21413,40840,909,15
kroA200.tsp,steepest-ls,188,18409,20180,38589,5352,15
kroB200.tsp,greedy-cycle,126,18041,20656,38697,2,15
kroA200.tsp,candidate-ls,16,20520,18456,38976,1420,15
kroA200.tsp,greedy-cycle,178,21586,18253,39839,2,15
kroB200.tsp,steepest-ls,140,19612,19624,39236,5082,15
kroA200.tsp,steepest-ls,26,19551,17812,37363,5460,15
kroB200.tsp,qc-ls,72,18810,20476,39286,804,15
kroB200.tsp,queue-ls,132,18381,19451,37832,863,15
kroA200.tsp,qc-ls,140,19172,18600,37772,838,15
kroA200.tsp,candidate-ls,104,19806,20327,40133,1483,15
kroB200.tsp,greedy-cycle,72,19306,17792,37098,2,15
kroB200.tsp,qc-ls,96,17644,21381,39025,855,15
kroB200.tsp,queue-ls,14,19677,19480,39157,878,15
kroA200.tsp,queue-ls,34,20371,16901,37272,894,15
kroB200.tsp,candidate-ls,82,19468,19487,38955,1469,15
kroB200.tsp,qc-ls,184,19118,17667,36785,819,15
kroB200.tsp,steepest-ls,16,19617,19415,39032,4924,15
kroA200.tsp,queue-ls,100,19676,19330,39006,865,15
kroA200.tsp,greedy-cycle,124,18327,19625,37952,3,15
kroB200.tsp,qc-ls,192,19739,20875,40614,865,15
kroB200.tsp,candidate-ls,94,17826,20191,38017,1569,15
kroA200.tsp,queue-ls,116,20099,20339,40438,832,15
kroA200.tsp,greedy-cycle,132,17402,18062,35464,2,15
kroB200.tsp,qc-ls,38,18992,20691,39683,899,15
kroA200.tsp,greedy-cycle,14,18444,18709,37153,2,15
kroB200.tsp,queue-ls,178,19621,18563,38184,851,15
kroB200.tsp,greedy-cycle,64,18157,20656,38813,2,15
kroA200.tsp,candidate-ls,112,20017,20775,40792,1593,15
kroA200.tsp,qc-ls,156,18136,20278,38414,915,15
kroB200.tsp,qc-ls,80,20309,19323,39632,806,15
kroA200.tsp,queue-ls,22,18703,19465,38168,821,15
kroB200.tsp,greedy-cycle,140,16949,21551,38500,2,15
kroA200.tsp,candidate-ls,186,20102,20083,40185,1484,15
kroA200.tsp,qc-ls,36,19372,19311,38683,849,15
kroA200.tsp,queue-ls,8,19319,19330,38649,819,15
kroA200.tsp,greedy-cycle,4,18193,21615,39808,2,15
kroA200.tsp,steepest-ls,4,19036,20776,39812,5379,15
kroB200.tsp,queue-ls,154,20032,19168,39200,890,15
kroA200.tsp,greedy-cycle,38,16872,20167,37039,3,15
kroB200.tsp,steepest-ls,126,20102,18247,38349,5171,15
kroA200.tsp,steepest-ls,40,19779,18283,38062,5059,15
kroB200.tsp,qc-ls,14,19630,19033,38663,858,15
kroB200.tsp,queue-ls,96,17339,19018,36357,819,15
kroA200.tsp,candidate-ls,70,19783,20196,39979,1477,15
kroB200.tsp,qc-ls,106,19550,20332,39882,821,15
kroB200.tsp,steepest-ls,94,18725,19198,37923,5526,15
kroA200.tsp,steepest-ls,156,19641,20547,40188,5121,15
kroA200.tsp,queue-ls,182,18822,20205,39027,851,15
kroB200.tsp,greedy-cycle,48,17075,19852,36927,3,15
kroB200.tsp,candidate-ls,160,18699,18875,37574,1450,15
kroA200.tsp,greedy-cycle,80,20726,17365,38091,3,15
kroB200.tsp,qc-ls,110,19472,18014,37486,860,15
kroB200.tsp,candidate-ls,16,17876,20873,38749,1552,15
kroA200.tsp,qc-ls,98,18148,20876,39024,796,15
kroA200.tsp,queue-ls,194,19618,20904,40522,853,15
kroA200.tsp,candidate-ls,128,20892,19196,40088,1436,15
kroA200.tsp,steepest-ls,140,18027,18887,36914,5145,15
kroB200.tsp,steepest-ls,82,18232,19236,37468,4890,15
kroB200.tsp,candidate-ls,176,18717,20609,39326,1498,15
kroA200.tsp,queue-ls,18,18866,18386,37252,840,15
kroB200.tsp,queue-ls,38,18782,19408,38190,814,15
kroB200.tsp,steepest-ls,188,20508,18618,39126,5217,15
kroA200.tsp,greedy-cycle,96,20726,17365,38091,2,15
kroA200.tsp,qc-ls,20,17677,19982,37659,883,15
kroA200.tsp,candidate-ls,190,20839,18491,39330,1473,15
kroB200.tsp,greedy-cycle,156,18713,20519,39232,2,15
kroA200.tsp,steepest-ls,56,18799,18908,37707,5348,15
kroB200.tsp,steepest-ls,130,19454,19774,39228,4969,15
kroB200.tsp,queue-ls,142,19273,20322,39595,879,15
kroA200.tsp,candidate-ls,66,19924,17534,37458,1498,15
kroA200.tsp,greedy-cycle,108,17458,22307,39765,2,15
kroB200.tsp,queue-ls,80,19050,20289,39339,798,15
kroB200.tsp,candidate-ls,156,17684,19580,37264,1538,15
kroA200.tsp,queue-ls,38,20362,17069,37431,868,15
kroA200.tsp,greedy-cycle,190,18444,18709,37153,2,15
kroB200.tsp,queue-ls,18,18342,19455,37797,870,15
kroA200.tsp,candidate-ls,108,19683,19669,39352,1434,15
kroA200.tsp,steepest-ls,160,20118,19024,39142,5074,15
kroB200.tsp,qc-ls,130,19775,18090,37865,788,15
kroB200.tsp,candidate-ls,36,20307,18132,38439,1583,15
kroA200.tsp,candidate-ls,46,19454,20780,40234,1545,15
kroA200.tsp,greedy-cycle,128,17061,20167,37228,2,15
kroA200.tsp,queue-ls,80,19107,19349,38456,863,15
kroB200.tsp,qc-ls,22,20317,20431,40748,783,15
kroA200.tsp,steepest-ls,76,20849,18163,39012,5298,15
kroB200.tsp,steepest-ls,110,19901,18167,38068,5405,15
kroB200.tsp,queue-ls,162,18299,20140,38439,828,15
kroB200.tsp,qc-ls,188,19763,18542,38305,769,15
kroB200.tsp,greedy-cycle,176,17622,20396,38018,2,15
kroA200.tsp,queue-ls,96,19764,18579,38343,890,15
kroA200.tsp,candidate-ls,50,17502,19960,37462,1535,15
kroB200.tsp,queue-ls,174,19369,19599,38968,871,15
kroA200.tsp,greedy-cycle,18,21703,18093,39796,2,15
kroB200.tsp,steepest-ls,106,19217,17907,37124,5230,15
kroA200.tsp,steepest-ls,60,18012,18487,36499,5281,15
kroB200.tsp,qc-ls,34,18319,19255,37574,822,15
kroB200.tsp,candidate-ls,98,20320,18673,38993,1504,15
kroB200.tsp,greedy-cycle,160,20257,18102,38359,2,15
kroA200.tsp,qc-ls,16,18621,19684,38305,772,15
kroB200.tsp,candidate-ls,6,19856,19100,38956,1454,15
kroA200.tsp,greedy-cycle,186,17458,22307,39765,2,15
kroB200.tsp,candidate-ls,140,20683,20037,40720,1452,15
kroA200.tsp,steepest-ls,176,19398,21011,40409,4620,15
kroB200.tsp,greedy-cycle,68,18449,21333,39782,2,15
kroB200.tsp,candidate-ls,20,20571,19121,39692,1383,15
kroB200.tsp,qc-ls,2,19721,19805,39526,822,15
kroB200.tsp,qc-ls,126,19077,18704,37781,849,15
kroB200.tsp,qc-ls,18,19567,18687,38254,818,15
kroA200.tsp,greedy-cycle,34,18327,19625,37952,2,15
kroB200.tsp,queue-ls,158,19736,17950,37686,909,15
kroA200.tsp,greedy-cycle,112,17402,18062,35464,2,15
kroA200.tsp,queue-ls,136,20008,19069,39077,904,15
kroB200.tsp,steepest-ls,20,19587,20150,39737,4718,15
kroA200.tsp,steepest-ls,8,19626,19177,38803,5377,15
kroA200.tsp,greedy-cycle,8,18388,17472,35860,2,15
kroA200.tsp,queue-ls,4,17988,20588,38576,844,15
kroB200.tsp,queue-ls,22,19170,19279,38449,812,15
kroB200.tsp,steepest-ls,192,18943,20877,39820,6491,15
kroA200.tsp,qc-ls,82,18862,20020,38882,860,15
kroB200.tsp,greedy-cycle,44,18987,16849,35836,3,15
kroA200.tsp,candidate-ls,132,18142,18874,37016,1601,15
kroA200.tsp,qc-ls,176,19139,19441,38580,905,15
kroB200.tsp,steepest-ls,98,20346,19077,39423,4913,15
kroB200.tsp,queue-ls,34,18744,19306,38050,839,15
kroA200.tsp,queue-ls,14,19600,20964,40564,882,15
kroB200.tsp,steepest-ls,184,19066,19292,38358,5149,15
kroA200.tsp,qc-ls,160,19169,21271,40440,818,15
kroA200.tsp,candidate-ls,124,19150,18895,38045,1420,15
kroA200.tsp,queue-ls,198,19263,19534,38797,819,15
kroB200.tsp,greedy-cycle,52,18256,21333,39589,2,15
kroA200.tsp,qc-ls,94,19581,18905,38486,885,15
kroA200.tsp,greedy-cycle,22,17669,22204,39873,2,15
kroA200.tsp,greedy-cycle,104,18193,21615,39808,2,15
kroB200.tsp,steepest-ls,36,19177,19081,38258,5209,15
kroA200.tsp,queue-ls,120,20633,18327,38960,855,15
kroA200.tsp,candidate-ls,6,20737,19091,39828,1506,15
kroA200.tsp,candidate-ls,172,20052,17796,37848,1496,15
kroA200.tsp,qc-ls,136,20623,19262,39885,849,15
kroA200.tsp,candidate-ls,84,17442,20374,37816,1560,15
kroA200.tsp,queue-ls,42,21226,17523,38749,833,15
kroB200.tsp,queue-ls,62,20018,18988,39006,815,15
kroA200.tsp,queue-ls,176,19133,20616,39749,897,15
kroB200.tsp,steepest-ls,60,19423,19343,38766,5330,15
kroB200.tsp,qc-ls,58,19422,20239,39661,815,15
kroB200.tsp,queue-ls,4,18765,20314,39079,883,15
kroA200.tsp,greedy-cycle,74,16553,22671,39224,3,15
kroB200.tsp,queue-ls,118,20603,19876,40479,804,15
kroB200.tsp,candidate-ls,194,20016,18879,38895,1471,15
kroA200.tsp,greedy-cycle,152,21564,18253,39817,2,15
kroB200.tsp,steepest-ls,76,20391,18017,38408,5141,15
kroA200.tsp,qc-ls,198,19058,19479,38537,832,15
kroA200.tsp,queue-ls,160,17463,21581,39044,819,15
kroA200.tsp,greedy-cycle,62,21596,18253,39849,2,15
kroA200.tsp,greedy-cycle,144,18444,18709,37153,3,15
kroA200.tsp,qc-ls,6,19182,18266,37448,819,15
kroB200.tsp,candidate-ls,182,19552,19665,39217,1503,15
kroA200.tsp,qc-ls,120,21110,18101,39211,901,15
kroA200.tsp,candidate-ls,164,20571,19378,39949,1574,15
kroB200.tsp,greedy-cycle,12,21562,18065,39627,2,15
kroB200.tsp,queue-ls,74,19260,18715,37975,844,15
kroA200.tsp,queue-ls,54,19278,19456,38734,835,15
kroA200.tsp,candidate-ls,92,19758,21447,41205,1451,15
kroB200.tsp,greedy-cycle,86,19202,20010,39212,2,15
kroA200.tsp,qc-ls,40,19391,19241,38632,756,15
kroB200.tsp,greedy-cycle,136,17606,20396,38002,2,15
kroA200.tsp,steepest-ls,198,19749,18573,38322,5311,15
kroA200.tsp,greedy-cycle,168,18327,19625,37952,2,15
kroB200.tsp,qc-ls,62,18435,19930,38365,867,15
kroA200.tsp,steepest-ls,36,19755,18401,38156,5399,15
kroB200.tsp,steepest-ls,150,18063,19845,37908,5302,15
kroB200.tsp,queue-ls,122,18011,19883,37894,873,15
kroA200.tsp,candidate-ls,148,18671,20699,39370,1478,15
kroA200.tsp,steepest-ls,120,19630,18021,37651,4915,15
kroB200.tsp,qc-ls,170,19095,19458,38553,836,15
kroB200.tsp,candidate-ls,76,20516,18218,38734,1497,15
kroB200.tsp,candidate-ls,116,21557,19073,40630,1473,15
kroA200.tsp,queue-ls,78,18748,18265,37013,891,15
kroB200.tsp,queue-ls,58,19687,18775,38462,864,15
kroA200.tsp,steepest-ls,136,19405,18640,38045,5243,15
kroB200.tsp,greedy-cycle,198,18034,20453,38487,2,15
kroB200.tsp,greedy-cycle,28,20711,18141,38852,2,15
kroB200.tsp,candidate-ls,60,18926,19221,38147,1490,15
kroA200.tsp,greedy-cycle,200,-1292857757,19152,-1292838605,2,15
kroB200.tsp,qc-ls,166,20223,19702,39925,910,15
kroA200.tsp,steepest-ls,98,21159,19272,40431,5268,15
kroB200.tsp,candidate-ls,100,20574,19123,39697,1501,15
kroB200.tsp,greedy-cycle,120,20853,18065,38918,2,15
kroA200.tsp,qc-ls,56,19657,21600,41257,851,15
kroB200.tsp,greedy-cycle,90,20595,18141,38736,2,15
kroB200.tsp,greedy-cycle,8,16995,21859,38854,2,15
kroA200.tsp,candidate-ls,10,17738,18862,36600,1548,15
kroB200.tsp,queue-ls,134,20151,20212,40363,810,15
kroA200.tsp,greedy-cycle,58,18893,20745,39638,3,15
kroB200.tsp,steepest-ls,146,18098,19886,37984,4997,15
kroA200.tsp,steepest-ls,20,19888,20689,40577,4953,15
kroB200.tsp,qc-ls,74,18885,20081,38966,831,15
kroB200.tsp,candidate-ls,120,18637,19889,38526,1488,15
kroA200.tsp,candidate-ls,88,19707,19570,39277,1443,15
kroB200.tsp,candidate-ls,40,19034,19455,38489,1582,15
kroB200.tsp,qc-ls,146,17522,20109,37631,817,15
kroA200.tsp,steepest-ls,116,19087,19017,38104,5034,15
kroA200.tsp,candidate-ls,200,18711,20050,38761,1494,15
kroB200.tsp,queue-ls,114,19796,19248,39044,833,15
kroA200.tsp,greedy-cycle,78,16626,21633,38259,3,15
kroB200.tsp,steepest-ls,166,19197,19315,38512,5328,15
kroB200.tsp,queue-ls,8,19360,18908,38268,888,15
kroB200.tsp,qc-ls,54,17667,21281,38948,801,15
kroB200.tsp,candidate-ls,198,21219,20676,41895,1553,15
kroA200.tsp,candidate-ls,30,19962,19896,39858,1504,15
kroB200.tsp,greedy-cycle,100,18449,21333,39782,2,15
kroA200.tsp,qc-ls,182,18855,19349,38204,864,15
kroA200.tsp,qc-ls,76,21589,18199,39788,866,15
kroB200.tsp,qc-ls,42,19187,21011,40198,828,15
kroA200.tsp,steepest-ls,16,19365,20717,40082,5177,15
kroB200.tsp,steepest-ls,170,20315,18580,38895,5044,15
kroB200.tsp,queue-ls,102,20825,20562,41387,844,15
kroA200.tsp,candidate-ls,26,20620,19225,39845,1574,15
kroA200.tsp,greedy-cycle,148,21345,18253,39598,2,15
kroA200.tsp,qc-ls,60,20535,18347,38882,860,15
kroA200.tsp,qc-ls,194,19573,19181,38754,869,15
kroB200.tsp,greedy-cycle,116,18352,21333,39685,2,15
kroB200.tsp,candidate-ls,136,18807,19521,38328,1499,15
kroA200.tsp,queue-ls,58,18293,18945,37238,822,15
kroB200.tsp,queue-ls,78,20004,19617,39621,858,15
kroB200.tsp,qc-ls,150,20024,18435,38459,858,15
kroB200.tsp,candidate-ls,56,18793,19997,38790,1478,15
kroA200.tsp,candidate-ls,168,20790,17830,38620,1426,15
kroA200.tsp,steepest-ls,100,17883,20079,37962,5376,15
kroA200.tsp,greedy-cycle,164,21218,17365,38583,2,15
kroA200.tsp,greedy-cycle,42,18193,21615,39808,2,15
kroB200.tsp,steepest-ls,56,19913,18485,38398,5024,15
kroA200.tsp,steepest-ls,194,18948,20194,39142,4929,15
kroA200.tsp,queue-ls,140,20270,18835,39105,847,15
kroB200.tsp,queue-ls,196,20070,19859,39929,772,15
kroA200.tsp,steepest-ls,82,20422,17177,37599,5619,15
kroB200.tsp,queue-ls,54,18438,18638,37076,849,15
kroA200.tsp,queue-ls,74,18833,19387,38220,860,15
kroA200.tsp,qc-ls,100,18990,18889,37879,788,15
kroB200.tsp,greedy-cycle,182,17742,20268,38010,2,15
kroA200.tsp,candidate-ls,144,19578,20134,39712,1507,15
kroB200.tsp,greedy-cycle,32,21676,18649,40325,2,15
kroA200.tsp,steepest-ls,94,19511,17876,37387,5079,15
kroB200.tsp,queue-ls,180,20989,16491,37480,911,15
kroA200.tsp,queue-ls,62,19822,18734,38556,827,15
kroB200.tsp,queue-ls,42,19278,19435,38713,854,15
kroB200.tsp,greedy-cycle,24,16972,21859,38831,2,15
kroA200.tsp,candidate-ls,152,19390,20690,40080,1453,15
kroB200.tsp,greedy-cycle,194,21184,18065,39249,2,15
kroA200.tsp,qc-ls,116,19601,19074,38675,836,15
kroA200.tsp,greedy-cycle,172,17669,22204,39873,2,15
kroB200.tsp,greedy-cycle,4,18449,21333,39782,2,15
kroB200.tsp,qc-ls,78,18767,18739,37506,822,15
kroA200.tsp,greedy-cycle,54,16614,21633,38247,3,15
kroB200.tsp,queue-ls,138,18756,19828,38584,819,15
kroA200.tsp,queue-ls,156,20235,20058,40293,862,15
kroA200.tsp,steepest-ls,182,18590,18624,37214,5128,15
kroB200.tsp,steepest-ls,40,18573,20608,39181,4890,15
kroB200.tsp,queue-ls,82,20042,20641,40683,793,15
kroA200.tsp,candidate-ls,64,18333,20416,38749,1485,15
kroB200.tsp,queue-ls,140,19923,18001,37924,852,15
kroA200.tsp,steepest-ls,54,19742,19460,39202,4937,15
kroB200.tsp,steepest-ls,132,18939,19119,38058,5661,15
kroB200.tsp,greedy-cycle,154,21486,18065,39551,2,15
kroB200.tsp,steepest-ls,38,19106,21037,40143,4830,15
kroA200.tsp,qc-ls,22,19567,19466,39033,861,15
kroA200.tsp,candidate-ls,192,19695,21800,41495,1477,15
kroA200.tsp,greedy-cycle,94,17926,22204,40130,2,15
kroB200.tsp,candidate-ls,174,18327,20404,38731,1566,15
kroB200.tsp,steepest-ls,80,18854,20302,39156,4868,15
kroA200.tsp,steepest-ls,142,20867,18384,39251,5261,15
kroA200.tsp,queue-ls,196,20394,18425,38819,832,15
kroB200.tsp,candidate-ls,14,18226,19457,37683,1539,15
kroB200.tsp,qc-ls,112,20400,19966,40366,786,15
kroA200.tsp,greedy-cycle,82,17202,20167,37369,5,15
kroB200.tsp,candidate-ls,162,18919,21292,40211,1406,15
kroA200.tsp,queue-ls,180,19735,20224,39959,850,15
kroA200.tsp,steepest-ls,154,19434,19513,38947,5451,15
kroB200.tsp,steepest-ls,96,18856,19196,38052,5148,15
kroA200.tsp,qc-ls,178,19348,17940,37288,815,15
kroB200.tsp,qc-ls,104,18036,19357,37393,1014,15
kroA200.tsp,candidate-ls,72,18582,18772,37354,1619,15
kroB200.tsp,queue-ls,94,19536,18970,38506,891,15
kroB200.tsp,steepest-ls,124,19092,18830,37922,5290,15
kroB200.tsp,qc-ls,16,18835,19039,37874,800,15
kroA200.tsp,steepest-ls,42,20324,18698,39022,5393,15
kroB200.tsp,queue-ls,156,17916,20053,37969,825,15
kroA200.tsp,greedy-cycle,6,18273,17472,35745,2,15
kroA200.tsp,steepest-ls,6,20645,19750,40395,5120,15
kroA200.tsp,candidate-ls,184,19791,19301,39092,1473,15
kroA200.tsp,queue-ls,138,18909,18766,37675,878,15
kroA200.tsp,qc-ls,34,18786,19383,38169,825,15
kroB200.tsp,greedy-cycle,142,17701,20396,38097,2,15
kroA200.tsp,greedy-cycle,188,21416,18093,39509,3,15
kroA200.tsp,queue-ls,20,19909,19842,39751,813,15
kroB200.tsp,candidate-ls,8,19476,20437,39913,1464,15
kroB200.tsp,qc-ls,82,19709,21488,41197,825,15
kroB200.tsp,qc-ls,128,19917,21210,41127,901,15
kroA200.tsp,qc-ls,154,20938,20048,40986,912,15
kroA200.tsp,steepest-ls,178,18817,18232,37049,4948,15
kroB200.tsp,greedy-cycle,66,18520,21333,39853,2,15
kroA200.tsp,candidate-ls,110,19835,18103,37938,1597,15
kroA200.tsp,greedy-cycle,16,16943,20139,37082,2,15
kroB200.tsp,steepest-ls,108,20019,18963,38982,4988,15
kroA200.tsp,queue-ls,98,20065,20695,40760,872,15
kroA200.tsp,greedy-cycle,130,21332,18093,39425,2,15
kroA200.tsp,qc-ls,18,18948,20059,39007,775,15
kroA200.tsp,queue-ls,114,20476,20071,40547,781,15
kroB200.tsp,candidate-ls,96,17800,22191,39991,1446,15
kroB200.tsp,qc-ls,190,18436,18676,37112,880,15
kroA200.tsp,steepest-ls,78,19373,18459,37832,5357,15
kroA200.tsp,candidate-ls,48,20183,18154,38337,1557,15
kroA200.tsp,greedy-cycle,126,16614,21633,38247,5,15
kroA200.tsp,queue-ls,102,18697,18728,37425,877,15
kroB200.tsp,steepest-ls,14,20617,20524,41141,4928,15
kroB200.tsp,greedy-cycle,178,18048,20656,38704,2,15
kroB200.tsp,qc-ls,186,17397,19873,37270,796,15
kroB200.tsp,candidate-ls,80,20030,20020,40050,1465,15
kroB200.tsp,candidate-ls,158,21204,20191,41395,1403,15
kroB200.tsp,queue-ls,16,19493,19637,39130,840,15
kroA200.tsp,queue-ls,36,21538,19069,40607,838,15
kroB200.tsp,qc-ls,94,20464,19752,40216,786,15
kroB200.tsp,candidate-ls,38,20177,19344,39521,1472,15
kroA200.tsp,candidate-ls,106,19957,19568,39525,1501,15
kroB200.tsp,greedy-cycle,70,20373,18102,38475,2,15
kroA200.tsp,qc-ls,142,17828,18083,35911,902,15
kroA200.tsp,queue-ls,122,18862,20047,38909,847,15
kroB200.tsp,steepest-ls,34,17684,20829,38513,5164,15
kroB200.tsp,greedy-cycle,158,17825,20246,38071,4,15
kroA200.tsp,candidate-ls,68,19020,18703,37723,1552,15
kroA200.tsp,greedy-cycle,106,17458,22307,39765,2,15
kroA200.tsp,steepest-ls,58,19119,16977,36096,5014,15
kroA200.tsp,greedy-cycle,20,17722,22204,39926,2,15
kroA200.tsp,candidate-ls,126,19809,19895,39704,1487,15
kroB200.tsp,greedy-cycle,50,21450,18385,39835,5,15
kroA200.tsp,qc-ls,96,20850,19093,39943,859,15
kroA200.tsp,qc-ls,162,18639,19420,38059,804,15
kroB200.tsp,candidate-ls,18,18855,20029,38884,1519,15
kroB200.tsp,steepest-ls,186,18321,19882,38203,5156,15
kroA200.tsp,greedy-cycle,98,21703,18093,39796,2,15
kroB200.tsp,candidate-ls,178,19899,20045,39944,1361,15
kroB200.tsp,queue-ls,36,18708,18845,37553,889,15
kroA200.tsp,queue-ls,16,18490,19665,38155,824,15
kroA200.tsp,qc-ls,174,21741,19018,40759,859,15
kroA200.tsp,steepest-ls,158,19186,18818,38004,5365,15
kroA200.tsp,qc-ls,80,19695,19101,38796,816,15
kroB200.tsp,greedy-cycle,46,17895,20656,38551,3,15
kroA200.tsp,candidate-ls,130,18942,19808,38750,1559,15
kroB200.tsp,qc-ls,108,21148,19959,41107,799,15
kroB200.tsp,steepest-ls,190,18142,19849,37991,5560,15
kroB200.tsp,queue-ls,20,18878,19437,38315,794,15
kroA200.tsp,queue-ls,6,19252,18122,37374,805,15
kroB200.tsp,steepest-ls,22,19308,18073,37381,5048,15
kroA200.tsp,qc-ls,38,21124,21429,42553,849,15
kroA200.tsp,queue-ls,134,18248,20568,38816,832,15
kroA200.tsp,candidate-ls,188,20049,19861,39910,1545,15
kroA200.tsp,greedy-cycle,110,17362,18993,36355,2,15
kroB200.tsp,queue-ls,98,20670,18039,38709,849,15
kroA200.tsp,greedy-cycle,36,18068,17472,35540,2,15
kroB200.tsp,steepest-ls,128,19068,18623,37691,5746,15
kroB200.tsp,qc-ls,124,19237,20420,39657,805,15
kroB200.tsp,candidate-ls,22,18987,19916,38903,1462,15
kroA200.tsp,steepest-ls,174,20187,20149,40336,5160,15
kroA200.tsp,qc-ls,158,18639,20414,39053,875,15
kroB200.tsp,candidate-ls,142,19556,20484,40040,1530,15
kroB200.tsp,candidate-ls,4,19304,20097,39401,1469,15
kroA200.tsp,greedy-cycle,184,17636,21615,39251,3,15
kroA200.tsp,queue-ls,118,20057,17469,37526,834,15
kroA200.tsp,qc-ls,14,20346,20297,40643,827,15
kroB200.tsp,greedy-cycle,162,17713,20396,38109,2,15
kroB200.tsp,steepest-ls,104,19434,20995,40429,4960,15
kroB200.tsp,qc-ls,36,19237,19537,38774,827,15
kroA200.tsp,steepest-ls,62,18599,18410,37009,5355,15
kroB200.tsp,queue-ls,176,17510,21082,38592,863,15
kroA200.tsp,candidate-ls,52,19259,18803,38062,1511,15
kroA200.tsp,queue-ls,94,21877,17483,39360,860,15
kroB200.tsp,greedy-cycle,174,20326,18102,38428,2,15
kroB200.tsp,steepest-ls,18,19226,18882,38108,5164,15
kroB200.tsp,queue-ls,160,19675,19659,39334,810,15
kroA200.tsp,steepest-ls,74,17760,19984,37744,5155,15
kroB200.tsp,qc-ls,20,20336,19182,39518,849,15
kroB200.tsp,steepest-ls,112,17992,20566,38558,4962,15
kroA200.tsp,queue-ls,82,18422,17480,35902,884,15
kroA200.tsp,candidate-ls,44,17993,20108,38101,1611,15
kroB200.tsp,candidate-ls,34,19160,20864,40024,1431,15
kroB200.tsp,qc-ls,132,19331,19594,38925,884,15
kroA200.tsp,steepest-ls,162,20400,18089,38489,5061,15
kroA200.tsp,greedy-cycle,192,17573,17750,35323,5,15
kroB200.tsp,candidate-ls,154,20780,18651,39431,1488,15
kroB200.tsp,qc-ls,98,18702,20715,39417,885,15
kroB200.tsp,steepest-ls,144,19890,21233,41123,4817,15
kroB200.tsp,qc-ls,76,19048,20087,39135,857,15
kroA200.tsp,steepest-ls,22,21152,20273,41425,4990,15
kroB200.tsp,queue-ls,136,19937,17887,37824,872,15
kroA200.tsp,candidate-ls,12,19670,18814,38484,1387,15
kroA200.tsp,queue-ls,158,20224,18138,38362,878,15
kroA200.tsp,qc-ls,54,21493,17662,39155,802,15
kroB200.tsp,greedy-cycle,92,20595,18141,38736,3,15
kroB200.tsp,greedy-cycle,122,18658,21333,39991,2,15
kroB200.tsp,candidate-ls,102,19197,20067,39264,1473,15
kroB200.tsp,qc-ls,164,18502,18922,37424,822,15
kroB200.tsp,candidate-ls,62,19504,19613,39117,1588,15
kroA200.tsp,steepest-ls,134,18536,19669,38205,5186,15
kroA200.tsp,qc-ls,118,20683,17690,38373,826,15
kroB200.tsp,candidate-ls,114,19047,19814,38861,1454,15
kroB200.tsp,queue-ls,198,18549,21433,39982,855,15
kroB200.tsp,candidate-ls,74,20084,19192,39276,1497,15
kroB200.tsp,qc-ls,172,18837,19783,38620,853,15
kroA200.tsp,steepest-ls,122,19163,19967,39130,5125,15
kroB200.tsp,steepest-ls,2,18797,19696,38493,5237,15
kroB200.tsp,queue-ls,120,20041,19624,39665,871,15
kroA200.tsp,steepest-ls,34,18482,19372,37854,4876,15
kroB200.tsp,qc-ls,60,19148,20015,39163,798,15
kroB200.tsp,steepest-ls,152,18371,19991,38362,4987,15
kroB200.tsp,greedy-cycle,134,18092,20396,38488,2,15
kroB200.tsp,steepest-ls,58,19140,18571,37711,5419,15
kroB200.tsp,greedy-cycle,84,19306,17792,37098,2,15
kroA200.tsp,qc-ls,42,20005,20998,41003,734,15
kroB200.tsp,candidate-ls,138,19655,18400,38055,1542,15
kroA200.tsp,candidate-ls,90,19086,18616,37702,1476,15
kroB200.tsp,queue-ls,76,20251,19368,39619,810,15
kroA200.tsp,queue-ls,56,19454,17609,37063,888,15
kroA200.tsp,candidate-ls,166,18180,19835,38015,1476,15
kroB200.tsp,greedy-cycle,10,20595,18141,38736,2,15
kroB200.tsp,steepest-ls,200,21415,18540,39955,4983,15
kroA200.tsp,qc-ls,122,19059,20522,39581,848,15
kroB200.tsp,candidate-ls,58,21980,19092,41072,1455,15
kroA200.tsp,qc-ls,4,20014,18987,39001,880,15
kroB200.tsp,candidate-ls,180,20338,18025,38363,1512,15
kroA200.tsp,candidate-ls,28,19817,18426,38243,1504,15
kroA200.tsp,greedy-cycle,146,18201,17472,35673,2,15
kroA200.tsp,steepest-ls,18,20279,18910,39189,5063,15
kroA200.tsp,greedy-cycle,60,18273,17472,35745,3,15
kroA200.tsp,queue-ls,162,18861,20327,39188,890,15
kroB200.tsp,steepest-ls,74,20926,18239,39165,4967,15
kroB200.tsp,greedy-cycle,118,17606,20396,38002,3,15
kroA200.tsp,greedy-cycle,150,16539,22671,39210,2,15
kroB200.tsp,candidate-ls,196,18628,21046,39674,1450,15
kroA200.tsp,greedy-cycle,76,17191,22196,39387,3,15
kroB200.tsp,queue-ls,6,20652,19106,39758,779,15
kroB200.tsp,steepest-ls,168,19703,18108,37811,5061,15
kroB200.tsp,steepest-ls,62,20718,20042,40760,5098,15
kroA200.tsp,qc-ls,78,20686,17750,38436,823,15
kroA200.tsp,queue-ls,174,18987,19808,38795,803,15
kroA200.tsp,queue-ls,40,19639,17449,37088,814,15
kroB200.tsp,queue-ls,60,21199,19692,40891,1035,15
kroA200.tsp,candidate-ls,86,20912,18058,38970,1562,15
kroA200.tsp,qc-ls,134,18176,19557,37733,891,15
kroA200.tsp,steepest-ls,118,19385,18488,37873,5213,15
kroA200.tsp,candidate-ls,170,17108,19501,36609,1597,15
kroA200.tsp,candidate-ls,4,18597,20653,39250,1615,15
kroB200.tsp,qc-ls,148,20936,17595,38531,765,15
kroB200.tsp,steepest-ls,42,19318,17804,37122,5266,15
kroA200.tsp,steepest-ls,180,19134,19239,38373,5178,15
kroA200.tsp,qc-ls,58,19552,20452,40004,817,15
kroA200.tsp,queue-ls,154,19726,18569,38295,809,15
kroA200.tsp,greedy-cycle,56,20906,18253,39159,2,15
kroB200.tsp,steepest-ls,148,20000,17801,37801,4934,15
kroA200.tsp,greedy-cycle,170,17168,20167,37335,2,15
kroB200.tsp,greedy-cycle,6,17307,21859,39166,2,15
kroB200.tsp,qc-ls,168,19864,19241,39105,892,15
kroA200.tsp,qc-ls,114,20216,17904,38120,855,15
kroB200.tsp,greedy-cycle,196,18520,21333,39853,2,15
kroA200.tsp,steepest-ls,138,19591,18628,38219,5514,15
kroB200.tsp,greedy-cycle,26,18700,20519,39219,3,15
kroA200.tsp,candidate-ls,150,20604,18258,38862,1472,15
kroA200.tsp,queue-ls,60,19092,20413,39505,909,15
kroB200.tsp,queue-ls,40,18788,19178,37966,896,15
kroB200.tsp,queue-ls,182,16740,20885,37625,884,15
kroA200.tsp,steepest-ls,96,19583,18773,38356,5396,15
kroB200.tsp,candidate-ls,78,18744,20990,39734,1486,15
kroA200.tsp,candidate-ls,146,20003,19982,39985,1526,15
kroB200.tsp,greedy-cycle,30,21184,18065,39249,2,15
kroB200.tsp,greedy-cycle,180,17206,20759,37965,2,15
kroA200.tsp,qc-ls,102,20041,20555,40596,818,15
kroB200.tsp,candidate-ls,118,19566,19948,39514,1550,15
kroB200.tsp,queue-ls,56,19639,18370,38009,854,15
kroA200.tsp,queue-ls,76,19479,19785,39264,867,15
kroA200.tsp,steepest-ls,80,17662,21383,39045,4989,15
kroB200.tsp,queue-ls,194,19039,17778,36817,866,15
kroA200.tsp,queue-ls,142,18067,19055,37122,964,15
kroB200.tsp,greedy-cycle,88,17798,20510,38308,2,15
kroA200.tsp,steepest-ls,196,18828,17818,36646,4835,15
kroB200.tsp,steepest-ls,54,18310,19701,38011,5411,15
kroB200.tsp,greedy-cycle,138,18500,20807,39307,3,15
kroA200.tsp,steepest-ls,38,19903,19585,39488,4971,15
kroA200.tsp,greedy-cycle,40,19236,21988,41224,3,15
kroB200.tsp,qc-ls,200,21089,18984,40073,809,15
kroA200.tsp,greedy-cycle,166,18122,21693,39815,4,15
kroA200.tsp,steepest-ls,102,18809,19263,38072,4960,15
kroB200.tsp,candidate-ls,54,18695,21334,40029,1475,15
kroB200.tsp,qc-ls,152,17756,20185,37941,848,15
kroB200.tsp,candidate-ls,134,20211,18201,38412,1568,15
kroB200.tsp,greedy-cycle,114,18160,20656,38816,2,15
kroA200.tsp,qc-ls,196,17217,20190,37407,893,15
kroB200.tsp,steepest-ls,78,19283,19297,38580,5077,15
kroA200.tsp,qc-ls,62,18559,19367,37926,833,15
kroA200.tsp,candidate-ls,24,18336,19605,37941,1533,15
kroA200.tsp,qc-ls,8,20645,18527,39172,853,15
kroB200.tsp,queue-ls,100,18822,19077,37899,898,15
kroA200.tsp,steepest-ls,14,18276,20629,38905,5187,15
kroB200.tsp,qc-ls,40,21332,17788,39120,811,15
kroB200.tsp,steepest-ls,172,18953,20133,39086,4931,15
kroA200.tsp,queue-ls,178,18379,19621,38000,904,15
kroA200.tsp,qc-ls,74,18714,20763,39477,813,15
kroA200.tsp,qc-ls,180,20191,19923,40114,749,15
kroB200.tsp,greedy-cycle,102,18638,20487,39125,2,15
kroA200.tsp,candidate-ls,32,18831,19991,38822,1566,15
kroB200.tsp,steepest-ls,164,19444,19248,38692,5200,15
kroB200.tsp,qc-ls,56,19600,18339,37939,803,15
kroB200.tsp,queue-ls,116,20041,19872,39913,880,15
kroA200.tsp,steepest-ls,114,19397,18974,38371,5233,15
kroA200.tsp,qc-ls,138,19862,19586,39448,757,15
kroB200.tsp,qc-ls,144,18832,19962,38794,835,15
kroA200.tsp,candidate-ls,8,20635,18080,38715,1454,15
kroB200.tsp,candidate-ls,42,20164,19393,39557,1491,15
kroB200.tsp,candidate-ls,122,20304,19544,39848,1459,15
kroB200.tsp,candidate-ls,200,18594,19153,37747,1521,15
kroB200.tsp,steepest-ls,32,19194,19199,38393,4868,15
kroA200.tsp,candidate-ls,198,19608,18221,37829,1526,15
kroA200.tsp,queue-ls,124,20135,17716,37851,781,15
kroA200.tsp,qc-ls,28,19176,19677,38853,829,15
kroB200.tsp,queue-ls,88,19229,19214,38443,805,15
kroA200.tsp,greedy-cycle,100,20757,17365,38122,2,15
kroA200.tsp,greedy-cycle,26,18444,18709,37153,2,15
kroB200.tsp,steepest-ls,138,19231,19113,38344,4933,15
kroA200.tsp,steepest-ls,148,19468,18641,38109,4853,15
kroA200.tsp,qc-ls,164,20412,17288,37700,800,15
kroA200.tsp,candidate-ls,120,17781,19526,37307,1467,15
kroA200.tsp,qc-ls,90,19546,18947,38493,825,15
kroB200.tsp,greedy-cycle,56,17191,21859,39050,3,15
kroB200.tsp,qc-ls,118,16687,20075,36762,858,15
kroB200.tsp,steepest-ls,180,19565,21080,40645,5120,15
kroB200.tsp,queue-ls,30,20879,19704,40583,879,15
kroA200.tsp,queue-ls,10,19059,18810,37869,833,15
kroB200.tsp,greedy-cycle,40,18987,16849,35836,2,15
kroA200.tsp,qc-ls,86,20061,19499,39560,856,15
kroA200.tsp,candidate-ls,136,19776,19472,39248,1557,15
kroA200.tsp,qc-ls,172,19308,18197,37505,792,15
kroB200.tsp,steepest-ls,196,17757,19111,36868,5402,15
kroA200.tsp,greedy-cycle,88,19236,21988,41224,2,15
kroB200.tsp,candidate-ls,168,19848,19182,39030,1441,15
kroB200.tsp,queue-ls,26,19782,19967,39749,830,15
kroA200.tsp,queue-ls,132,19479,20273,39752,845,15
kroB200.tsp,greedy-cycle,148,18256,21333,39589,2,15
kroB200.tsp,steepest-ls,24,20420,19986,40406,5526,15
kroA200.tsp,candidate-ls,78,20384,17720,38104,1407,15
kroA200.tsp,greedy-cycle,116,17362,18993,36355,2,15
kroA200.tsp,steepest-ls,48,18324,19426,37750,5139,15
kroA200.tsp,greedy-cycle,30,16527,21633,38160,2,15
kroB200.tsp,candidate-ls,24,20575,20221,40796,1542,15
kroB200.tsp,qc-ls,122,19382,20020,39402,805,15
kroB200.tsp,qc-ls,6,19456,18886,38342,830,15
kroA200.tsp,steepest-ls,172,20699,18402,39101,4866,15
kroB200.tsp,candidate-ls,2,19275,19842,39117,1493,15
kroA200.tsp,greedy-cycle,182,16583,22671,39254,2,15
kroB200.tsp,candidate-ls,144,20444,20640,41084,1454,15
kroB200.tsp,qc-ls,88,19405,18266,37671,812,15
kroB200.tsp,greedy-cycle,164,17789,20510,38299,2,15
kroA200.tsp,qc-ls,12,20121,19233,39354,796,15
kroB200.tsp,queue-ls,170,20327,18802,39129,894,15
kroB200.tsp,steepest-ls,102,18991,20078,39069,4728,15
kroB200.tsp,qc-ls,30,20167,18741,38908,835,15
kroA200.tsp,steepest-ls,64,18071,18952,37023,5406,15
kroA200.tsp,queue-ls,92,19945,19831,39776,823,15
kroA200.tsp,candidate-ls,54,18727,19380,38107,1549,15
kroA200.tsp,queue-ls,108,20587,17963,38550,875,15
kroB200.tsp,greedy-cycle,172,18878,19742,38620,2,15
kroA200.tsp,steepest-ls,72,19254,20485,39739,4987,15
kroB200.tsp,qc-ls,26,17944,20352,38296,825,15
kroB200.tsp,steepest-ls,114,19766,20451,40217,4832,15
kroB200.tsp,queue-ls,166,18312,19816,38128,861,15
kroA200.tsp,candidate-ls,42,19971,20123,40094,1395,15
kroA200.tsp,queue-ls,84,18698,20355,39053,909,15
kroB200.tsp,qc-ls,134,20921,20353,41274,763,15
kroB200.tsp,candidate-ls,32,19216,18954,38170,1603,15
kroA200.tsp,qc-ls,148,18133,20403,38536,882,15
kroA200.tsp,steepest-ls,164,19683,19389,39072,4916,15
kroB200.tsp,candidate-ls,152,20147,19086,39233,1518,15
kroA200.tsp,greedy-cycle,194,17402,18062,35464,2,15
kroA200.tsp,candidate-ls,62,19084,19234,38318,1481,15
kroB200.tsp,queue-ls,84,19090,19158,38248,841,15
kroA200.tsp,steepest-ls,52,19868,21326,41194,5087,15
kroB200.tsp,steepest-ls,134,19620,18894,38514,5312,15
kroB200.tsp,queue-ls,146,17976,21110,39086,909,15
kroA200.tsp,qc-ls,24,19702,17309,37011,762,15
kroA200.tsp,queue-ls,128,21823,19386,41209,824,15
kroA200.tsp,candidate-ls,194,18889,19467,38356,1540,15
kroB200.tsp,greedy-cycle,152,17976,20396,38372,2,15
kroA200.tsp,greedy-cycle,92,18206,17472,35678,2,15
kroB200.tsp,candidate-ls,172,19732,18022,37754,1593,15
kroA200.tsp,queue-ls,190,21673,18672,40345,858,15
kroA200.tsp,qc-ls,168,20417,18797,39214,778,15
kroB200.tsp,steepest-ls,86,19014,20724,39738,5335,15
kroA200.tsp,steepest-ls,144,19180,18277,37457,5265,15
kroB200.tsp,qc-ls,114,19194,19372,38566,794,15
kroB200.tsp,candidate-ls,12,19004,19946,38950,1510,15
kroA200.tsp,greedy-cycle,84,18444,18709,37153,2,15
kroB200.tsp,candidate-ls,164,19035,19259,38294,1446,15
kroA200.tsp,steepest-ls,152,19106,19813,38919,5047,15
kroB200.tsp,steepest-ls,90,19603,19488,39091,4814,15
kroA200.tsp,queue-ls,186,20205,17999,38204,909,15
kroB200.tsp,qc-ls,102,20015,18248,38263,846,15
kroB200.tsp,queue-ls,92,18648,19055,37703,889,15
kroA200.tsp,candidate-ls,74,19036,20549,39585,1559,15
kroB200.tsp,queue-ls,150,17846,19095,36941,896,15
kroB200.tsp,steepest-ls,122,20080,19105,39185,5120,15
kroA200.tsp,qc-ls,200,19486,18304,37790,832,15
kroB200.tsp,qc-ls,10,19384,17321,36705,791,15
kroA200.tsp,steepest-ls,44,18366,19678,38044,5140,15
kroB200.tsp,steepest-ls,28,19297,18493,37790,5091,15
kroB200.tsp,greedy-cycle,144,17789,20510,38299,2,15
kroA200.tsp,candidate-ls,182,18716,21248,39964,1503,15
kroA200.tsp,qc-ls,32,20793,19109,39902,829,15
kroB200.tsp,candidate-ls,148,20424,18744,39168,1539,15
kroA200.tsp,queue-ls,26,18147,19469,37616,863,15
kroB200.tsp,qc-ls,84,19154,19379,38533,843,15
kroB200.tsp,candidate-ls,28,18912,20133,39045,1439,15
kroB200.tsp,greedy-cycle,60,18725,20274,38999,2,15
kroA200.tsp,candidate-ls,116,18973,19892,38865,1523,15
kroA200.tsp,qc-ls,152,17928,19735,37663,814,15
kroA200.tsp,steepest-ls,68,20548,18100,38648,5114,15
kroA200.tsp,steepest-ls,200,20784,18639,39423,4957,15
kroA200.tsp,greedy-cycle,10,21163,17365,38528,2,15
kroA200.tsp,candidate-ls,58,19593,20105,39698,1482,15
kroA200.tsp,greedy-cycle,136,18193,21615,39808,2,15
kroA200.tsp,queue-ls,112,20735,19210,39945,905,15
kroB200.tsp,greedy-cycle,168,17191,20902,38093,2,15
kroB200.tsp,qc-ls,196,19457,20003,39460,792,15
kroB200.tsp,candidate-ls,90,18938,19958,38896,1527,15
kroB200.tsp,steepest-ls,118,20240,18943,39183,5129,15
kroA200.tsp,greedy-cycle,120,17924,17472,35396,2,15
kroA200.tsp,queue-ls,88,18177,20732,38909,906,15
kroB200.tsp,steepest-ls,12,18941,19468,38409,5058,15
kroA200.tsp,queue-ls,104,17229,20583,37812,836,15
kroB200.tsp,candidate-ls,86,18512,19339,37851,1698,15
kroB200.tsp,qc-ls,180,21299,17865,39164,874,15
kroB200.tsp,queue-ls,10,18707,18824,37531,895,15
kroA200.tsp,queue-ls,30,20353,17563,37916,846,15
kroA200.tsp,greedy-cycle,198,18273,17472,35745,2,15
kroB200.tsp,greedy-cycle,200,18745,21184,39929,2,15
kroB200.tsp,qc-ls,92,18763,19247,38010,830,15
kroB200.tsp,qc-ls,138,20763,16997,37760,749,15
kroA200.tsp,steepest-ls,168,18981,17922,36903,5401,15
kroA200.tsp,qc-ls,144,17440,20106,37546,859,15
kroA200.tsp,candidate-ls,100,19483,17838,37321,1614,15
kroB200.tsp,greedy-cycle,76,17910,20396,38306,2,15
kroB200.tsp,greedy-cycle,98,20595,18141,38736,2,15
kroA200.tsp,queue-ls,152,21209,17156,38365,818,15
kroB200.tsp,greedy-cycle,128,20595,18141,38736,2,15
kroB200.tsp,steepest-ls,44,19529,18133,37662,5533,15
kroA200.tsp,steepest-ls,186,19637,18995,38632,4983,15
kroA200.tsp,steepest-ls,28,20192,19516,39708,5293,15
kroA200.tsp,greedy-cycle,50,21589,18253,39842,4,15
kroA200.tsp,candidate-ls,18,20149,19041,39190,1440,15
kroA200.tsp,greedy-cycle,176,16626,21633,38259,2,15
kroB200.tsp,candidate-ls,68,21218,18767,39985,1467,15
kroB200.tsp,greedy-cycle,20,16866,22271,39137,2,15
kroA200.tsp,candidate-ls,156,21849,17583,39432,1567,15
kroA200.tsp,qc-ls,112,18345,19481,37826,883,15
kroB200.tsp,greedy-cycle,190,17713,20396,38109,2,15
kroB200.tsp,candidate-ls,108,20656,19037,39693,1500,15
kroA200.tsp,queue-ls,66,20764,18477,39241,816,15
kroB200.tsp,queue-ls,46,19293,18752,38045,889,15
kroA200.tsp,steepest-ls,90,18719,19744,38463,5261,15
kroB200.tsp,queue-ls,184,19523,20582,40105,859,15
kroB200.tsp,qc-ls,178,18560,19389,37949,796,15
kroA200.tsp,steepest-ls,128,19435,18460,37895,5200,15
kroB200.tsp,greedy-cycle,186,21562,18065,39627,2,15
kroA200.tsp,qc-ls,104,18081,19312,37393,853,15
kroB200.tsp,steepest-ls,8,18847,19679,38526,5078,15
kroA200.tsp,candidate-ls,140,17784,20279,38063,1586,15
kroB200.tsp,greedy-cycle,36,18249,20790,39039,2,15
kroB200.tsp,queue-ls,50,18846,19745,38591,870,15
kroA200.tsp,queue-ls,70,18340,21725,40065,799,15
kroB200.tsp,queue-ls,192,17921,19064,36985,956,15
kroA200.tsp,steepest-ls,86,19295,19228,38523,4926,15
kroA200.tsp,steepest-ls,190,19912,20090,40002,4835,15
kroB200.tsp,steepest-ls,52,18772,19663,38435,5240,15
kroA200.tsp,queue-ls,144,18603,19577,38180,855,15
kroA200.tsp,qc-ls,48,20651,18294,38945,861,15
kroA200.tsp,greedy-cycle,46,16527,21633,38160,6,15
kroB200.tsp,steepest-ls,158,20907,17576,38483,5386,15
kroA200.tsp,greedy-cycle,160,17683,22307,39990,5,15
kroA200.tsp,qc-ls,128,20328,17584,37912,994,15
kroA200.tsp,steepest-ls,104,19720,21200,40920,4912,15
kroB200.tsp,qc-ls,154,18692,19369,38061,870,15
kroB200.tsp,candidate-ls,52,19769,20539,40308,1462,15
kroB200.tsp,candidate-ls,132,19737,19132,38869,1385,15
kroA200.tsp,qc-ls,64,19923,18248,38171,813,15
kroA200.tsp,queue-ls,168,20455,18040,38495,875,15
kroB200.tsp,greedy-cycle,112,18164,20656,38820,2,15
kroA200.tsp,qc-ls,190,20177,18827,39004,820,15
kroA200.tsp,candidate-ls,22,21551,18095,39646,1441,15
kroA200.tsp,steepest-ls,12,17828,20369,38197,4997,15
kroB200.tsp,qc-ls,46,21045,17733,38778,858,15
kroB200.tsp,steepest-ls,174,18206,19970,38176,5039,15
kroB200.tsp,queue-ls,106,17898,20450,38348,862,15
kroB200.tsp,steepest-ls,68,19540,20295,39835,5310,15
kroA200.tsp,qc-ls,186,19694,20765,40459,803,15
kroB200.tsp,greedy-cycle,104,17976,20396,38372,2,15
kroA200.tsp,qc-ls,72,19305,17471,36776,871,15
kroA200.tsp,candidate-ls,34,19376,19633,39009,1432,15
kroB200.tsp,queue-ls,110,20642,17550,38192,837,15
kroB200.tsp,steepest-ls,162,19176,18989,38165,5048,15
kroB200.tsp,qc-ls,50,18695,20561,39256,798,15
kroA200.tsp,steepest-ls,112,20052,18332,38384,5424,15
kroB200.tsp,candidate-ls,44,18876,18753,37629,1438,15
kroB200.tsp,qc-ls,142,21141,18771,39912,776,15
kroA200.tsp,queue-ls,200,16341,18288,34629,993,15
kroB200.tsp,candidate-ls,124,18534,19574,38108,1525,15
kroB200.tsp,queue-ls,130,19630,18334,37964,867,15
kroB200.tsp,steepest-ls,142,18589,21191,39780,5286,15
kroB200.tsp,qc-ls,70,18944,19887,38831,816,15
kroA200.tsp,steepest-ls,24,17998,19389,37387,5060,15
kroA200.tsp,candidate-ls,14,18804,19678,38482,1475,15
kroB200.tsp,steepest-ls,48,20277,18931,39208,5105,15
kroB200.tsp,greedy-cycle,124,20857,18065,38922,2,15
kroB200.tsp,greedy-cycle,94,16866,22271,39137,2,15
kroA200.tsp,qc-ls,52,19213,19326,38539,792,15
kroB200.tsp,candidate-ls,104,18491,20056,38547,1602,15
kroB200.tsp,queue-ls,188,18669,19151,37820,853,15
kroB200.tsp,candidate-ls,64,18602,20263,38865,1513,15
kroB200.tsp,qc-ls,162,18840,20785,39625,823,15
kroA200.tsp,steepest-ls,132,18896,20129,39025,4956,15
kroB200.tsp,candidate-ls,112,18297,20267,38564,1496,15
kroB200.tsp,qc-ls,174,19595,18270,37865,812,15
kroB200.tsp,candidate-ls,72,18213,21559,39772,1467,15
kroB200.tsp,steepest-ls,4,18689,20172,38861,5215,15
kroA200.tsp,qc-ls,108,18776,18589,37365,839,15
kroA200.tsp,steepest-ls,124,20057,17964,38021,4879,15
kroA200.tsp,steepest-ls,32,18193,19598,37791,5441,15
kroB200.tsp,qc-ls,66,18286,19542,37828,844,15
kroB200.tsp,steepest-ls,154,19699,18869,38568,5426,15
kroB200.tsp,queue-ls,126,20335,18237,38572,818,15
kroA200.tsp,qc-ls,44,19203,17560,36763,954,15
kroB200.tsp,greedy-cycle,82,21149,18773,39922,2,15
kroA200.tsp,queue-ls,148,20527,18074,38601,813,15
kroB200.tsp,greedy-cycle,132,17789,20510,38299,2,15
kroB200.tsp,queue-ls,70,17951,21178,39129,836,15
kroA200.tsp,queue-ls,50,18442,20042,38484,840,15
kroA200.tsp,candidate-ls,96,19110,19958,39068,1481,15
kroA200.tsp,steepest-ls,108,19915,17585,37500,5376,15
kroA200.tsp,qc-ls,124,19764,18125,37889,869,15
kroA200.tsp,candidate-ls,160,19312,18852,38164,1551,15
kroB200.tsp,greedy-cycle,16,18884,16849,35733,2,15
kroB200.tsp,qc-ls,158,20589,18929,39518,846,15
kroA200.tsp,greedy-cycle,140,17168,20167,37335,2,15
kroB200.tsp,candidate-ls,186,19133,18878,38011,1499,15
kroA200.tsp,qc-ls,2,19899,21136,41035,806,15
kroA200.tsp,greedy-cycle,66,16527,21633,38160,3,15
kroB200.tsp,steepest-ls,178,19006,21401,40407,5166,15
kroB200.tsp,steepest-ls,72,20562,19780,40342,4993,15
kroA200.tsp,queue-ls,164,18632,19112,37744,803,15
kroA200.tsp,qc-ls,68,19002,19471,38473,820,15
kroA200.tsp,candidate-ls,38,19112,18437,37549,1471,15
kroB200.tsp,candidate-ls,190,17704,20130,37834,1612,15
kroA200.tsp,greedy-cycle,156,17458,22307,39765,2,15
kroA200.tsp,greedy-cycle,70,16872,20167,37039,2,15
kroA200.tsp,queue-ls,172,20532,19320,39852,827,15
kroB200.tsp,greedy-cycle,108,17812,17483,35295,2,15
kroB200.tsp,steepest-ls,64,21013,18446,39459,5136,15
kroA200.tsp,candidate-ls,80,18864,20570,39434,1431,15
kroB200.tsp,candidate-ls,128,18450,19250,37700,1498,15
kroA200.tsp,queue-ls,46,17916,21640,39556,849,15
kroB200.tsp,queue-ls,66,19034,19660,38694,900,15
kroA200.tsp,candidate-ls,176,20301,18002,38303,1519,15
kroA200.tsp,qc-ls,132,19593,17587,37180,802,15
kroA200.tsp,candidate-ls,2,19618,20634,40252,1461,15
kroB200.tsp,candidate-ls,48,19959,18898,38857,1576,15
