instance,solver,init_solver,neighbourhood,start_vertex,cost_first,cost_second,duration,total_cost
kroA100.tsp,greedy-ls,random-walk,N1,84,20812,18627,399,39439
kroA100.tsp,steepest-ls,random-walk,N2,73,16163,11609,326,27772
kroB100.tsp,steepest-ls,greedy-cycle,N1,38,11027,15534,101,26561
kroB100.tsp,greedy-ls,greedy-cycle,N2,15,14317,10353,27,24670
kroB100.tsp,steepest-ls,random-walk,N1,18,21631,20842,576,42473
kroA100.tsp,greedy-ls,random-walk,N2,94,14346,12569,270,26915
kroB100.tsp,steepest-ls,greedy-cycle,N2,28,11194,14354,60,25548
kroA100.tsp,steepest-ls,random-walk,N1,63,19136,17830,410,36966
kroB100.tsp,greedy-ls,greedy-cycle,N1,33,13785,10967,253,24752
kroA100.tsp,greedy-ls,greedy-cycle,N2,17,14428,11657,28,26085
kroA100.tsp,steepest-ls,random-walk,N2,24,15320,12348,333,27668
kroB100.tsp,greedy-ls,greedy-cycle,N1,52,12635,14757,34,27392
kroA100.tsp,greedy-ls,greedy-cycle,N1,50,11625,16077,52,27702
kroA100.tsp,steepest-ls,greedy-cycle,N2,49,15513,12386,41,27899
kroB100.tsp,steepest-ls,greedy-cycle,N1,80,11027,15534,121,26561
kroA100.tsp,steepest-ls,random-walk,N1,34,25124,14491,613,39615
kroB100.tsp,greedy-ls,greedy-cycle,N2,42,14317,10857,16,25174
kroA100.tsp,steepest-ls,greedy-cycle,N1,59,14595,11657,36,26252
kroA100.tsp,greedy-ls,greedy-cycle,N2,40,11481,14401,41,25882
kroA100.tsp,greedy-ls,greedy-cycle,N1,3,12386,15198,22,27584
kroB100.tsp,greedy-ls,greedy-cycle,N1,64,15011,10924,161,25935
kroB100.tsp,steepest-ls,greedy-cycle,N2,90,11506,14572,255,26078
kroB100.tsp,steepest-ls,random-walk,N2,49,15224,13104,481,28328
kroB100.tsp,greedy-ls,greedy-cycle,N1,44,14392,11444,30,25836
kroB100.tsp,steepest-ls,greedy-cycle,N1,79,11219,16084,159,27303
kroA100.tsp,steepest-ls,random-walk,N2,32,15406,10705,312,26111
kroB100.tsp,steepest-ls,greedy-cycle,N1,96,15985,11305,62,27290
kroA100.tsp,greedy-ls,greedy-cycle,N1,46,12386,15198,31,27584
kroB100.tsp,greedy-ls,greedy-cycle,N2,54,12420,14523,27,26943
kroB100.tsp,steepest-ls,random-walk,N1,59,18830,21504,483,40334
kroA100.tsp,steepest-ls,random-walk,N1,22,23906,20348,494,44254
kroB100.tsp,steepest-ls,greedy-cycle,N2,69,10344,13876,63,24220
kroB100.tsp,steepest-ls,greedy-cycle,N2,86,10838,15443,200,26281
kroB100.tsp,greedy-ls,greedy-cycle,N1,72,11316,17195,191,28511
kroA100.tsp,greedy-ls,greedy-cycle,N2,56,15198,12386,32,27584
kroA100.tsp,steepest-ls,random-walk,N2,65,16109,10176,354,26285
kroA100.tsp,greedy-ls,random-walk,N1,92,23506,13929,884,37435
kroB100.tsp,steepest-ls,random-walk,N1,7,22367,20955,802,43322
kroB100.tsp,greedy-ls,greedy-cycle,N1,13,14941,11792,40,26733
kroB100.tsp,greedy-ls,random-walk,N1,9,21006,23300,554,44306
kroA100.tsp,steepest-ls,random-walk,N1,5,23193,22379,593,45572
kroA100.tsp,greedy-ls,greedy-cycle,N1,11,14770,11657,28,26427
kroA100.tsp,steepest-ls,random-walk,N1,75,16953,20505,374,37458
kroA100.tsp,greedy-ls,random-walk,N2,82,15235,11844,662,27079
kroA100.tsp,steepest-ls,greedy-cycle,N1,18,14595,11657,40,26252
kroB100.tsp,greedy-ls,greedy-cycle,N1,25,10827,16739,166,27566
kroB100.tsp,greedy-ls,greedy-cycle,N1,87,12359,13865,34,26224
kroA100.tsp,steepest-ls,greedy-cycle,N2,73,11502,14991,117,26493
kroB100.tsp,steepest-ls,greedy-cycle,N1,55,15347,11907,94,27254
kroA100.tsp,greedy-ls,greedy-cycle,N1,85,11502,15434,26,26936
kroB100.tsp,greedy-ls,greedy-cycle,N1,68,11862,16557,34,28419
kroB100.tsp,greedy-ls,random-walk,N1,27,22227,19865,649,42092
kroB100.tsp,steepest-ls,random-walk,N2,65,15747,11432,334,27179
kroB100.tsp,greedy-ls,greedy-cycle,N2,97,11194,14532,38,25726
kroA100.tsp,steepest-ls,greedy-cycle,N1,63,14698,11657,27,26355
kroA100.tsp,greedy-ls,random-walk,N2,16,15186,11427,195,26613
kroB100.tsp,steepest-ls,greedy-cycle,N2,45,14882,10859,87,25741
kroA100.tsp,greedy-ls,greedy-cycle,N2,95,11657,14435,16,26092
kroB100.tsp,steepest-ls,random-walk,N1,75,22494,21854,555,44348
kroB100.tsp,greedy-ls,random-walk,N2,37,16956,14168,258,31124
kroB100.tsp,greedy-ls,greedy-cycle,N2,78,14883,11305,139,26188
kroA100.tsp,greedy-ls,random-walk,N1,51,20348,19292,703,39640
kroA100.tsp,steepest-ls,greedy-cycle,N2,24,14147,11657,64,25804
kroB100.tsp,greedy-ls,random-walk,N1,70,27297,17213,211,44510
kroB100.tsp,steepest-ls,random-walk,N2,32,14675,10836,489,25511
kroA100.tsp,steepest-ls,random-walk,N2,49,16386,10092,298,26478
kroB100.tsp,steepest-ls,random-walk,N2,2,16460,11758,431,28218
kroB100.tsp,greedy-ls,greedy-cycle,N1,1,12212,15826,177,28038
kroA100.tsp,greedy-ls,random-walk,N2,41,15438,11950,1361,27388
kroA100.tsp,steepest-ls,greedy-cycle,N1,34,11713,15934,60,27647
kroB100.tsp,steepest-ls,random-walk,N1,22,16824,19164,478,35988
kroB100.tsp,greedy-ls,random-walk,N2,60,15609,12879,231,28488
kroA100.tsp,steepest-ls,random-walk,N1,59,22725,24160,350,46885
kroB100.tsp,steepest-ls,greedy-cycle,N2,12,11194,14354,69,25548
kroB100.tsp,greedy-ls,random-walk,N1,89,25881,20127,193,46008
kroA100.tsp,steepest-ls,greedy-cycle,N2,32,14428,11657,63,26085
kroA100.tsp,greedy-ls,random-walk,N1,47,21785,17923,614,39708
kroB100.tsp,steepest-ls,greedy-cycle,N1,14,14899,10763,120,25662
kroB100.tsp,greedy-ls,greedy-cycle,N1,29,11194,15678,20,26872
kroB100.tsp,greedy-ls,random-walk,N1,66,19887,20907,230,40794
kroB100.tsp,steepest-ls,random-walk,N2,24,14865,11343,284,26208
kroB100.tsp,greedy-ls,random-walk,N2,99,15445,12666,822,28111
kroA100.tsp,steepest-ls,greedy-cycle,N1,22,15486,12386,72,27872
kroA100.tsp,greedy-ls,random-walk,N2,57,14888,12956,224,27844
kroB100.tsp,steepest-ls,random-walk,N1,34,21147,18821,864,39968
kroB100.tsp,greedy-ls,random-walk,N2,76,14831,13693,255,28524
kroB100.tsp,greedy-ls,greedy-cycle,N2,39,10153,16670,24,26823
kroA100.tsp,greedy-ls,random-walk,N1,10,19309,21347,318,40656
kroA100.tsp,steepest-ls,greedy-cycle,N2,65,15198,12386,700,27584
kroB100.tsp,greedy-ls,greedy-cycle,N1,91,11220,15678,16,26898
kroA100.tsp,greedy-ls,greedy-cycle,N2,6,15513,12386,22,27899
kroB100.tsp,greedy-ls,random-walk,N1,31,21088,18850,242,39938
kroB100.tsp,steepest-ls,random-walk,N2,73,16525,10163,658,26688
kroA100.tsp,greedy-ls,greedy-cycle,N1,93,12027,13870,11,25897
kroB100.tsp,steepest-ls,greedy-cycle,N1,43,12450,13865,274,26315
kroB100.tsp,greedy-ls,greedy-cycle,N1,48,14520,10555,382,25075
kroA100.tsp,steepest-ls,greedy-cycle,N1,75,15198,12386,54,27584
kroB100.tsp,greedy-ls,greedy-cycle,N2,81,11283,16850,29,28133
kroB100.tsp,steepest-ls,random-walk,N1,63,24486,25534,864,50020
kroB100.tsp,greedy-ls,random-walk,N2,21,16416,13386,176,29802
kroA100.tsp,greedy-ls,greedy-cycle,N2,83,11713,15281,38,26994
kroB100.tsp,steepest-ls,greedy-cycle,N2,53,10153,16651,37,26804
kroA100.tsp,steepest-ls,random-walk,N1,18,22732,17960,487,40692
kroB100.tsp,steepest-ls,greedy-cycle,N2,24,14384,11305,56,25689
kroA100.tsp,greedy-ls,random-walk,N2,98,15528,12920,223,28448
kroB100.tsp,steepest-ls,random-walk,N1,14,20858,24045,694,44903
kroB100.tsp,greedy-ls,random-walk,N2,56,15213,12996,591,28209
kroB100.tsp,greedy-ls,greedy-cycle,N2,19,14113,11222,43,25335
kroA100.tsp,greedy-ls,random-walk,N2,77,14602,12577,189,27179
kroB100.tsp,steepest-ls,greedy-cycle,N2,2,14317,10353,81,24670
kroA100.tsp,steepest-ls,random-walk,N1,80,20391,22084,650,42475
kroB100.tsp,steepest-ls,greedy-cycle,N1,34,10827,16739,20,27566
kroA100.tsp,greedy-ls,random-walk,N1,88,21943,17913,238,39856
kroB100.tsp,greedy-ls,random-walk,N1,46,20738,20009,264,40747
kroA100.tsp,steepest-ls,greedy-cycle,N2,12,11713,14957,68,26670
kroA100.tsp,greedy-ls,random-walk,N1,67,18774,19597,218,38371
kroA100.tsp,steepest-ls,random-walk,N2,90,15737,14968,288,30705
kroB100.tsp,steepest-ls,random-walk,N1,43,22022,24878,541,46900
kroB100.tsp,greedy-ls,greedy-cycle,N1,87,12440,14482,383,26922
kroB100.tsp,steepest-ls,greedy-cycle,N2,73,11108,13814,60,24922
kroA100.tsp,steepest-ls,random-walk,N1,38,19559,21116,502,40675
kroB100.tsp,greedy-ls,greedy-cycle,N1,68,12218,15252,645,27470
kroA100.tsp,greedy-ls,random-walk,N2,20,13808,12253,206,26061
kroA100.tsp,steepest-ls,greedy-cycle,N1,55,11713,15934,50,27647
kroB100.tsp,greedy-ls,random-walk,N1,11,21946,14937,438,36883
kroB100.tsp,steepest-ls,random-walk,N2,53,16881,12240,379,29121
kroA100.tsp,steepest-ls,greedy-cycle,N1,7,11713,15934,76,27647
kroA100.tsp,steepest-ls,random-walk,N2,28,16487,10287,323,26774
kroB100.tsp,steepest-ls,greedy-cycle,N1,63,14408,10577,124,24985
kroA100.tsp,greedy-ls,random-walk,N2,2,15892,12942,215,28834
kroB100.tsp,greedy-ls,greedy-cycle,N2,7,10837,15789,17,26626
kroA100.tsp,greedy-ls,random-walk,N1,30,19472,22743,252,42215
kroA100.tsp,steepest-ls,greedy-cycle,N2,45,14435,11657,59,26092
kroB100.tsp,steepest-ls,greedy-cycle,N2,65,11505,16324,54,27829
kroB100.tsp,greedy-ls,greedy-cycle,N1,91,11220,15678,140,26898
kroB100.tsp,steepest-ls,random-walk,N1,55,20966,10766,543,31732
kroB100.tsp,greedy-ls,random-walk,N2,17,16056,12355,218,28411
kroB100.tsp,greedy-ls,greedy-cycle,N2,58,10837,15562,46,26399
kroA100.tsp,steepest-ls,greedy-cycle,N1,43,12386,15198,53,27584
kroA100.tsp,greedy-ls,random-walk,N2,36,15043,13810,353,28853
kroB100.tsp,steepest-ls,greedy-cycle,N1,75,11027,15534,155,26561
kroB100.tsp,greedy-ls,greedy-cycle,N1,48,14407,11649,27,26056
kroB100.tsp,steepest-ls,random-walk,N2,45,15780,12114,449,27894
kroA100.tsp,steepest-ls,greedy-cycle,N2,53,15486,12386,46,27872
kroA100.tsp,greedy-ls,random-walk,N1,26,21257,17428,510,38685
kroB100.tsp,greedy-ls,random-walk,N2,40,15085,12500,339,27585
kroA100.tsp,steepest-ls,random-walk,N1,79,22633,20050,466,42683
kroB100.tsp,steepest-ls,greedy-cycle,N2,32,11194,14354,77,25548
kroA100.tsp,steepest-ls,random-walk,N1,96,23683,21630,393,45313
kroB100.tsp,greedy-ls,greedy-cycle,N1,29,11261,15678,304,26939
kroA100.tsp,greedy-ls,random-walk,N2,61,15032,13429,316,28461
kroA100.tsp,steepest-ls,greedy-cycle,N1,14,12386,15198,76,27584
kroB100.tsp,greedy-ls,random-walk,N1,50,22294,19755,321,42049
kroB100.tsp,steepest-ls,random-walk,N2,12,13900,13666,465,27566
kroB100.tsp,greedy-ls,random-walk,N1,5,18282,19876,323,38158
kroB100.tsp,greedy-ls,greedy-cycle,N2,100,10587,14785,35,25372
kroB100.tsp,steepest-ls,greedy-cycle,N1,22,15347,11907,51,27254
kroA100.tsp,steepest-ls,random-walk,N2,69,14154,11237,343,25391
kroA100.tsp,steepest-ls,random-walk,N2,86,13730,11745,344,25475
kroA100.tsp,greedy-ls,random-walk,N1,71,18624,17395,405,36019
kroA100.tsp,steepest-ls,random-walk,N1,9,22633,20724,441,43357
kroB100.tsp,greedy-ls,greedy-cycle,N1,52,12635,14798,296,27433
kroA100.tsp,greedy-ls,greedy-cycle,N2,76,11657,14435,19,26092
kroB100.tsp,steepest-ls,random-walk,N1,96,21243,15888,544,37131
kroB100.tsp,greedy-ls,greedy-cycle,N2,74,12541,13601,56,26142
kroB100.tsp,steepest-ls,random-walk,N1,79,25839,17600,558,43439
kroA100.tsp,steepest-ls,greedy-cycle,N1,80,11860,11668,105,23528
kroA100.tsp,greedy-ls,greedy-cycle,N2,99,14435,11657,16,26092
kroB100.tsp,steepest-ls,greedy-cycle,N2,49,10838,15443,149,26281
kroA100.tsp,greedy-ls,greedy-cycle,N1,66,15198,12386,25,27584
kroB100.tsp,steepest-ls,random-walk,N2,86,16227,13793,397,30020
kroB100.tsp,steepest-ls,random-walk,N2,69,14102,11649,418,25751
kroB100.tsp,greedy-ls,greedy-cycle,N1,64,14899,11113,32,26012
kroA100.tsp,greedy-ls,greedy-cycle,N1,89,13485,12074,63,25559
kroA100.tsp,steepest-ls,greedy-cycle,N2,90,15513,12386,44,27899
kroA100.tsp,greedy-ls,greedy-cycle,N2,100,12386,15198,24,27584
kroB100.tsp,steepest-ls,greedy-cycle,N1,59,11205,15678,141,26883
kroA100.tsp,steepest-ls,random-walk,N2,12,15383,10812,322,26195
kroB100.tsp,greedy-ls,random-walk,N2,83,17688,11712,408,29400
kroA100.tsp,greedy-ls,greedy-cycle,N2,21,14435,11657,24,26092
kroA100.tsp,steepest-ls,greedy-cycle,N1,38,14581,11657,40,26238
kroA100.tsp,steepest-ls,random-walk,N1,55,23016,17152,447,40168
kroB100.tsp,greedy-ls,greedy-cycle,N2,23,15254,11907,28,27161
kroB100.tsp,greedy-ls,random-walk,N1,93,23780,17889,240,41669
kroA100.tsp,steepest-ls,greedy-cycle,N2,28,13353,12498,77,25851
kroA100.tsp,greedy-ls,greedy-cycle,N1,31,11860,11668,36,23528
kroA100.tsp,steepest-ls,random-walk,N2,45,16818,14740,314,31558
kroB100.tsp,greedy-ls,greedy-cycle,N1,33,14317,11760,32,26077
kroB100.tsp,greedy-ls,greedy-cycle,N1,13,15054,11372,122,26426
kroA100.tsp,greedy-ls,greedy-cycle,N2,37,11502,14770,28,26272
kroB100.tsp,greedy-ls,random-walk,N2,95,15614,13925,231,29539
kroB100.tsp,greedy-ls,greedy-cycle,N2,35,10827,15707,19,26534
kroB100.tsp,steepest-ls,random-walk,N1,38,21855,23229,748,45084
kroA100.tsp,steepest-ls,random-walk,N1,43,25626,16360,486,41986
kroA100.tsp,greedy-ls,greedy-cycle,N1,27,11713,15934,25,27647
kroB100.tsp,greedy-ls,random-walk,N1,85,21850,18521,189,40371
kroB100.tsp,steepest-ls,random-walk,N2,28,15834,11464,446,27298
kroB100.tsp,greedy-ls,greedy-cycle,N1,25,10827,16739,11,27566
kroB100.tsp,steepest-ls,greedy-cycle,N1,7,10826,16765,37,27591
kroA100.tsp,steepest-ls,random-walk,N2,53,15603,10816,478,26419
kroB100.tsp,steepest-ls,greedy-cycle,N1,18,15576,11305,49,26881
kroB100.tsp,steepest-ls,random-walk,N1,80,26980,18921,659,45901
kroA100.tsp,steepest-ls,greedy-cycle,N1,79,15486,12386,76,27872
kroA100.tsp,steepest-ls,greedy-cycle,N2,2,11502,14991,119,26493
kroA100.tsp,greedy-ls,greedy-cycle,N2,60,11762,15533,20,27295
kroB100.tsp,greedy-ls,greedy-cycle,N1,44,15369,11444,231,26813
kroA100.tsp,steepest-ls,random-walk,N1,14,25802,14886,413,40688
kroA100.tsp,greedy-ls,random-walk,N1,7,26074,17779,229,43853
kroA100.tsp,steepest-ls,greedy-cycle,N1,96,11502,15434,60,26936
kroB100.tsp,greedy-ls,greedy-cycle,N2,62,10344,14008,48,24352
kroB100.tsp,greedy-ls,greedy-cycle,N1,2,15054,10617,24,25671
kroB100.tsp,steepest-ls,random-walk,N2,90,14995,12389,392,27384
kroA100.tsp,greedy-ls,greedy-cycle,N1,70,15486,12386,33,27872
kroA100.tsp,steepest-ls,greedy-cycle,N2,69,11502,14991,118,26493
kroA100.tsp,steepest-ls,greedy-cycle,N2,86,11713,14957,92,26670
kroB100.tsp,greedy-ls,greedy-cycle,N1,72,11449,17177,22,28626
kroB100.tsp,steepest-ls,random-walk,N2,91,15863,11793,481,27656
kroA100.tsp,steepest-ls,greedy-cycle,N2,68,11502,14424,73,25926
kroA100.tsp,greedy-ls,greedy-cycle,N1,71,12386,15198,34,27584
kroA100.tsp,steepest-ls,greedy-cycle,N2,87,11698,14957,826,26655
kroB100.tsp,greedy-ls,greedy-cycle,N1,73,11119,15138,25,26257
kroB100.tsp,steepest-ls,random-walk,N1,81,16305,20350,613,36655
kroA100.tsp,steepest-ls,greedy-cycle,N2,3,12386,15198,64,27584
kroA100.tsp,greedy-ls,greedy-cycle,N2,61,11698,15015,22,26713
kroA100.tsp,steepest-ls,greedy-cycle,N1,78,11502,15434,67,26936
kroB100.tsp,greedy-ls,greedy-cycle,N1,45,16703,10859,241,27562
kroA100.tsp,steepest-ls,random-walk,N1,15,22452,23923,461,46375
kroA100.tsp,greedy-ls,random-walk,N1,6,21533,17527,840,39060
kroA100.tsp,steepest-ls,greedy-cycle,N1,97,15198,12386,61,27584
kroB100.tsp,greedy-ls,greedy-cycle,N2,63,14204,10353,56,24557
kroB100.tsp,greedy-ls,greedy-cycle,N1,3,11108,15138,24,26246
kroA100.tsp,greedy-ls,greedy-cycle,N1,26,15198,12386,24,27584
kroB100.tsp,greedy-ls,random-walk,N1,84,21229,17921,271,39150
kroB100.tsp,steepest-ls,random-walk,N2,29,17096,12799,374,29895
kroB100.tsp,greedy-ls,greedy-cycle,N1,24,14434,11867,32,26301
kroB100.tsp,steepest-ls,greedy-cycle,N1,6,14317,10763,143,25080
kroA100.tsp,steepest-ls,random-walk,N2,52,14418,10222,318,24640
kroB100.tsp,steepest-ls,greedy-cycle,N1,19,15985,11305,43,27290
kroB100.tsp,greedy-ls,greedy-cycle,N1,12,11194,15678,339,26872
kroA100.tsp,greedy-ls,greedy-cycle,N2,36,14435,11657,23,26092
kroB100.tsp,greedy-ls,random-walk,N2,94,16018,13095,281,29113
kroB100.tsp,greedy-ls,greedy-cycle,N2,34,10827,15415,33,26242
kroB100.tsp,steepest-ls,random-walk,N1,39,19964,22033,571,41997
kroA100.tsp,steepest-ls,random-walk,N1,42,28415,20117,461,48532
kroB100.tsp,greedy-ls,random-walk,N1,92,18182,17224,231,35406
kroA100.tsp,greedy-ls,greedy-cycle,N1,30,12333,15086,30,27419
kroA100.tsp,steepest-ls,greedy-cycle,N2,29,12386,15198,121,27584
kroA100.tsp,steepest-ls,random-walk,N2,44,14975,10603,307,25578
kroB100.tsp,greedy-ls,greedy-cycle,N1,32,11220,15678,16,26898
kroB100.tsp,greedy-ls,random-walk,N2,82,16335,11276,689,27611
kroA100.tsp,steepest-ls,greedy-cycle,N1,39,12333,15083,61,27416
kroA100.tsp,greedy-ls,greedy-cycle,N2,20,11429,14066,41,25495
kroB100.tsp,greedy-ls,random-walk,N2,1,16900,11214,232,28114
kroA100.tsp,steepest-ls,random-walk,N1,54,24847,24648,353,49495
kroB100.tsp,greedy-ls,greedy-cycle,N2,22,15144,11907,30,27051
kroA100.tsp,greedy-ls,greedy-cycle,N1,67,13148,12828,34,25976
kroB100.tsp,steepest-ls,random-walk,N2,87,16612,12835,620,29447
kroB100.tsp,steepest-ls,random-walk,N2,68,14002,12022,783,26024
kroB100.tsp,greedy-ls,greedy-cycle,N1,65,11493,16694,32,28187
kroA100.tsp,steepest-ls,greedy-cycle,N2,91,14435,11657,52,26092
kroA100.tsp,greedy-ls,greedy-cycle,N1,88,15486,12386,24,27872
kroB100.tsp,greedy-ls,random-walk,N2,100,18025,14810,938,32835
kroB100.tsp,steepest-ls,greedy-cycle,N1,58,10826,16765,30,27591
kroA100.tsp,steepest-ls,random-walk,N2,13,16072,13099,322,29171
kroB100.tsp,greedy-ls,greedy-cycle,N1,53,10342,16742,218,27084
kroA100.tsp,greedy-ls,greedy-cycle,N2,77,11762,15533,28,27295
kroB100.tsp,steepest-ls,random-walk,N1,97,22763,17920,447,40683
kroB100.tsp,greedy-ls,greedy-cycle,N2,75,11103,15324,34,26427
kroB100.tsp,steepest-ls,random-walk,N1,78,17383,18768,508,36151
kroA100.tsp,greedy-ls,greedy-cycle,N2,98,14157,11657,32,25814
kroA100.tsp,steepest-ls,greedy-cycle,N1,81,11698,16222,86,27920
kroB100.tsp,steepest-ls,greedy-cycle,N2,48,14317,10353,152,24670
kroB100.tsp,greedy-ls,random-walk,N1,4,23129,19954,740,43083
kroB100.tsp,greedy-ls,random-walk,N1,51,22064,16351,256,38415
kroB100.tsp,steepest-ls,random-walk,N2,13,15400,12156,278,27556
kroB100.tsp,steepest-ls,greedy-cycle,N1,23,15347,11907,87,27254
kroA100.tsp,steepest-ls,random-walk,N2,68,15777,11289,335,27066
kroA100.tsp,steepest-ls,random-walk,N2,87,16251,11841,467,28092
kroA100.tsp,greedy-ls,random-walk,N1,70,18980,14333,395,33313
kroA100.tsp,steepest-ls,random-walk,N1,8,21018,15288,820,36306
kroB100.tsp,greedy-ls,random-walk,N2,41,14526,12176,184,26702
kroA100.tsp,steepest-ls,random-walk,N1,78,24271,20856,423,45127
kroB100.tsp,steepest-ls,greedy-cycle,N2,33,14317,10353,57,24670
kroA100.tsp,steepest-ls,random-walk,N1,97,21815,16953,465,38768
kroB100.tsp,greedy-ls,greedy-cycle,N1,28,11220,15678,260,26898
kroA100.tsp,greedy-ls,random-walk,N2,60,15615,10276,555,25891
kroA100.tsp,steepest-ls,greedy-cycle,N1,15,14770,11657,44,26427
kroB100.tsp,steepest-ls,greedy-cycle,N1,74,12450,13865,266,26315
kroB100.tsp,greedy-ls,greedy-cycle,N1,49,11250,15302,51,26552
kroB100.tsp,steepest-ls,random-walk,N2,44,17106,11958,640,29064
kroA100.tsp,steepest-ls,greedy-cycle,N2,52,11502,14424,62,25926
kroA100.tsp,greedy-ls,random-walk,N1,27,25450,19886,222,45336
kroB100.tsp,steepest-ls,greedy-cycle,N2,64,14017,10353,101,24370
kroB100.tsp,greedy-ls,greedy-cycle,N1,90,12212,15826,378,28038
kroB100.tsp,steepest-ls,random-walk,N1,54,23241,17296,600,40537
kroB100.tsp,greedy-ls,random-walk,N2,16,15385,12607,347,27992
kroB100.tsp,greedy-ls,greedy-cycle,N2,59,11194,14653,33,25847
kroA100.tsp,steepest-ls,greedy-cycle,N1,42,11860,11668,93,23528
kroA100.tsp,greedy-ls,random-walk,N2,37,16922,13869,216,30791
kroB100.tsp,greedy-ls,random-walk,N1,10,25017,21389,243,46406
kroB100.tsp,steepest-ls,random-walk,N2,52,14868,12262,331,27130
kroA100.tsp,steepest-ls,greedy-cycle,N1,6,15513,12386,60,27899
kroA100.tsp,steepest-ls,random-walk,N2,29,13624,12647,311,26271
kroB100.tsp,steepest-ls,greedy-cycle,N1,62,10730,14227,110,24957
kroA100.tsp,greedy-ls,random-walk,N2,3,15471,13204,311,28675
kroA100.tsp,greedy-ls,random-walk,N1,31,23160,18271,530,41431
kroB100.tsp,greedy-ls,greedy-cycle,N2,6,14204,10796,33,25000
kroA100.tsp,steepest-ls,greedy-cycle,N2,44,11502,14991,106,26493
kroB100.tsp,steepest-ls,random-walk,N1,42,26630,17973,1623,44603
kroB100.tsp,greedy-ls,greedy-cycle,N1,86,11191,15282,275,26473
kroB100.tsp,steepest-ls,greedy-cycle,N2,72,10628,17104,66,27732
kroA100.tsp,steepest-ls,random-walk,N1,39,20971,19075,472,40046
kroB100.tsp,greedy-ls,greedy-cycle,N1,69,10565,15349,323,25914
kroA100.tsp,greedy-ls,random-walk,N2,21,16588,13353,230,29941
kroA100.tsp,steepest-ls,greedy-cycle,N1,54,11600,14330,74,25930
kroB100.tsp,steepest-ls,greedy-cycle,N1,35,10827,16739,18,27566
kroA100.tsp,greedy-ls,random-walk,N1,89,19350,17155,344,36505
kroB100.tsp,greedy-ls,random-walk,N1,47,25157,19910,304,45067
kroA100.tsp,steepest-ls,greedy-cycle,N2,13,11657,14435,47,26092
kroA100.tsp,greedy-ls,random-walk,N1,66,23198,19683,304,42881
kroA100.tsp,steepest-ls,random-walk,N2,91,14583,12392,365,26975
kroB100.tsp,steepest-ls,greedy-cycle,N2,25,10827,15415,46,26242
kroA100.tsp,greedy-ls,random-walk,N2,99,14534,12503,313,27037
kroB100.tsp,steepest-ls,random-walk,N1,15,20968,19145,561,40113
kroB100.tsp,greedy-ls,random-walk,N2,57,16242,10799,476,27041
kroB100.tsp,greedy-ls,greedy-cycle,N2,18,14525,11867,27,26392
kroB100.tsp,steepest-ls,greedy-cycle,N2,3,11108,13814,62,24922
kroA100.tsp,greedy-ls,random-walk,N2,76,15546,11831,195,27377
kroA100.tsp,steepest-ls,random-walk,N1,81,24842,19137,876,43979
kroB100.tsp,greedy-ls,greedy-cycle,N1,49,11250,15415,571,26665
kroA100.tsp,steepest-ls,greedy-cycle,N1,74,14595,11657,46,26252
kroB100.tsp,greedy-ls,greedy-cycle,N2,80,10851,15214,41,26065
kroB100.tsp,steepest-ls,random-walk,N1,62,20097,22253,1398,42350
kroB100.tsp,greedy-ls,random-walk,N2,20,15404,13783,217,29187
kroA100.tsp,greedy-ls,greedy-cycle,N2,82,11657,14435,29,26092
kroB100.tsp,steepest-ls,greedy-cycle,N2,52,12420,14523,76,26943
kroA100.tsp,steepest-ls,random-walk,N1,19,24536,16706,630,41242
kroA100.tsp,greedy-ls,random-walk,N1,11,23680,14299,487,37979
kroA100.tsp,steepest-ls,greedy-cycle,N2,64,11502,14991,204,26493
kroB100.tsp,greedy-ls,greedy-cycle,N1,90,12212,15896,44,28108
kroB100.tsp,greedy-ls,random-walk,N1,30,20627,13542,266,34169
kroB100.tsp,steepest-ls,random-walk,N2,72,16173,13739,468,29912
kroA100.tsp,greedy-ls,greedy-cycle,N2,7,11669,15500,20,27169
kroA100.tsp,greedy-ls,greedy-cycle,N1,92,11860,11693,48,23553
kroB100.tsp,steepest-ls,greedy-cycle,N1,42,14408,10577,272,24985
kroB100.tsp,greedy-ls,random-walk,N2,98,15020,13423,770,28443
kroA100.tsp,steepest-ls,greedy-cycle,N1,23,14770,11657,55,26427
kroA100.tsp,greedy-ls,random-walk,N2,56,14813,12617,222,27430
kroB100.tsp,steepest-ls,random-walk,N1,35,18365,16457,835,34822
kroB100.tsp,greedy-ls,random-walk,N2,77,14901,13979,235,28880
kroB100.tsp,greedy-ls,greedy-cycle,N2,38,10693,15594,38,26287
kroB100.tsp,greedy-ls,random-walk,N1,88,18150,21087,272,39237
kroA100.tsp,steepest-ls,greedy-cycle,N2,33,11657,14435,56,26092
kroA100.tsp,greedy-ls,random-walk,N1,46,21771,19881,1001,41652
kroB100.tsp,steepest-ls,greedy-cycle,N1,15,14317,10763,67,25080
kroB100.tsp,greedy-ls,greedy-cycle,N1,28,11194,15678,18,26872
kroB100.tsp,greedy-ls,random-walk,N1,67,26763,18180,196,44943
kroB100.tsp,steepest-ls,random-walk,N2,25,15356,12114,370,27470
kroB100.tsp,steepest-ls,random-walk,N2,3,16009,12637,289,28646
kroA100.tsp,greedy-ls,random-walk,N2,40,15685,12032,1194,27717
kroA100.tsp,steepest-ls,greedy-cycle,N1,35,11713,15934,68,27647
kroB100.tsp,steepest-ls,random-walk,N1,23,18853,18832,452,37685
kroB100.tsp,greedy-ls,random-walk,N2,61,14935,11283,432,26218
kroA100.tsp,steepest-ls,random-walk,N2,1,14208,10713,385,24921
kroA100.tsp,steepest-ls,random-walk,N1,58,22362,16622,356,38984
kroB100.tsp,steepest-ls,greedy-cycle,N2,13,14317,10353,52,24670
kroA100.tsp,greedy-ls,random-walk,N1,50,21035,21245,345,42280
kroA100.tsp,steepest-ls,greedy-cycle,N2,25,11698,15245,206,26943
kroB100.tsp,greedy-ls,random-walk,N1,71,23074,15988,215,39062
kroB100.tsp,steepest-ls,random-walk,N2,33,16811,10104,535,26915
kroA100.tsp,steepest-ls,random-walk,N2,48,15446,13147,291,28593
kroB100.tsp,greedy-ls,greedy-cycle,N2,96,14540,11305,44,25845
kroA100.tsp,steepest-ls,greedy-cycle,N1,62,11915,15550,38,27465
kroA100.tsp,greedy-ls,random-walk,N2,17,15466,12995,224,28461
kroB100.tsp,steepest-ls,greedy-cycle,N2,44,14060,11444,48,25504
kroA100.tsp,greedy-ls,greedy-cycle,N2,94,15513,12386,22,27899
kroB100.tsp,steepest-ls,random-walk,N1,74,20111,20799,573,40910
kroB100.tsp,greedy-ls,random-walk,N2,36,16558,13020,257,29578
kroB100.tsp,greedy-ls,greedy-cycle,N2,79,11256,16793,34,28049
kroB100.tsp,greedy-ls,greedy-cycle,N1,86,11250,15415,34,26665
kroA100.tsp,steepest-ls,greedy-cycle,N2,72,14435,11657,56,26092
kroB100.tsp,steepest-ls,greedy-cycle,N1,54,12635,14757,104,27392
kroA100.tsp,greedy-ls,greedy-cycle,N1,84,14581,11657,15,26238
kroB100.tsp,greedy-ls,greedy-cycle,N1,69,11087,13866,49,24953
kroB100.tsp,greedy-ls,random-walk,N1,26,27005,19430,300,46435
kroB100.tsp,steepest-ls,random-walk,N2,64,17343,9775,441,27118
kroA100.tsp,steepest-ls,random-walk,N1,74,27194,19215,369,46409
kroA100.tsp,greedy-ls,random-walk,N2,83,15371,12446,252,27817
kroA100.tsp,steepest-ls,greedy-cycle,N1,19,15198,12386,75,27584
kroB100.tsp,greedy-ls,greedy-cycle,N1,24,14864,11305,1040,26169
kroA100.tsp,steepest-ls,random-walk,N2,64,16634,14908,299,31542
kroA100.tsp,greedy-ls,random-walk,N1,93,24756,14277,998,39033
kroB100.tsp,steepest-ls,random-walk,N1,6,24174,18496,855,42670
kroB100.tsp,greedy-ls,greedy-cycle,N1,12,11194,15678,19,26872
kroB100.tsp,greedy-ls,random-walk,N1,8,19118,17774,285,36892
kroA100.tsp,steepest-ls,random-walk,N1,4,26387,19283,731,45670
kroA100.tsp,greedy-ls,greedy-cycle,N1,10,14595,11657,25,26252
kroB100.tsp,greedy-ls,greedy-cycle,N2,55,15141,11733,148,26874
kroB100.tsp,steepest-ls,random-walk,N1,58,20983,23441,426,44424
kroA100.tsp,steepest-ls,random-walk,N1,23,20333,21528,750,41861
kroB100.tsp,steepest-ls,greedy-cycle,N2,68,10896,15873,58,26769
kroB100.tsp,steepest-ls,greedy-cycle,N2,87,12450,13601,86,26051
kroB100.tsp,greedy-ls,greedy-cycle,N1,73,11119,15138,418,26257
kroA100.tsp,greedy-ls,greedy-cycle,N2,57,11713,15229,41,26942
kroB100.tsp,steepest-ls,random-walk,N2,48,15291,13959,311,29250
kroB100.tsp,greedy-ls,greedy-cycle,N1,45,16479,10859,29,27338
kroB100.tsp,steepest-ls,greedy-cycle,N1,78,15576,11305,66,26881
kroA100.tsp,steepest-ls,random-walk,N2,33,14855,13186,345,28041
kroB100.tsp,steepest-ls,greedy-cycle,N1,97,11205,15678,61,26883
kroA100.tsp,greedy-ls,greedy-cycle,N1,47,14995,11657,26,26652
kroA100.tsp,steepest-ls,random-walk,N1,35,21061,25019,2137,46080
kroB100.tsp,greedy-ls,greedy-cycle,N2,43,12359,13862,44,26221
kroA100.tsp,greedy-ls,greedy-cycle,N2,41,12386,15198,28,27584
kroA100.tsp,steepest-ls,greedy-cycle,N1,58,11480,15146,80,26626
kroA100.tsp,greedy-ls,greedy-cycle,N1,2,11502,15202,36,26704
kroB100.tsp,greedy-ls,greedy-cycle,N1,65,11666,16493,343,28159
kroB100.tsp,steepest-ls,greedy-cycle,N2,91,11194,14354,103,25548
kroA100.tsp,steepest-ls,random-walk,N2,25,15314,12340,395,27654
kroB100.tsp,greedy-ls,greedy-cycle,N1,53,10629,16742,19,27371
kroA100.tsp,steepest-ls,greedy-cycle,N2,48,12386,15198,57,27584
kroA100.tsp,greedy-ls,greedy-cycle,N1,51,11698,15934,26,27632
kroB100.tsp,steepest-ls,greedy-cycle,N1,81,11219,16084,149,27303
kroB100.tsp,greedy-ls,greedy-cycle,N2,14,14546,10477,30,25023
kroB100.tsp,steepest-ls,random-walk,N1,19,23862,18715,497,42577
kroA100.tsp,greedy-ls,random-walk,N2,95,16300,12471,229,28771
kroB100.tsp,steepest-ls,greedy-cycle,N2,29,11194,14354,61,25548
kroA100.tsp,steepest-ls,random-walk,N1,62,26524,25957,569,52481
kroB100.tsp,greedy-ls,greedy-cycle,N1,32,11194,15678,461,26872
kroA100.tsp,greedy-ls,greedy-cycle,N2,16,15513,12386,19,27899
kroA100.tsp,greedy-ls,random-walk,N1,85,23002,20611,324,43613
kroA100.tsp,steepest-ls,random-walk,N2,72,13980,11452,315,25432
kroB100.tsp,steepest-ls,greedy-cycle,N1,39,10342,16742,114,27084
kroB100.tsp,steepest-ls,random-walk,N1,12,19819,18826,557,38645
kroB100.tsp,greedy-ls,random-walk,N2,50,15977,10845,185,26822
kroB100.tsp,steepest-ls,greedy-cycle,N2,22,14968,11907,51,26875
kroA100.tsp,steepest-ls,random-walk,N1,69,21213,14463,388,35676
kroB100.tsp,greedy-ls,greedy-cycle,N1,39,10342,16742,198,27084
kroA100.tsp,greedy-ls,random-walk,N2,71,13499,13564,227,27063
kroB100.tsp,steepest-ls,greedy-cycle,N2,4,14317,10353,78,24670
kroA100.tsp,steepest-ls,random-walk,N1,86,24166,16104,384,40270
kroB100.tsp,greedy-ls,random-walk,N1,40,19307,17702,290,37009
kroA100.tsp,steepest-ls,random-walk,N2,79,13831,11697,303,25528
kroB100.tsp,steepest-ls,greedy-cycle,N1,32,11205,15678,39,26883
kroA100.tsp,greedy-ls,random-walk,N1,61,27132,17099,247,44231
kroA100.tsp,steepest-ls,random-walk,N2,96,14518,13373,299,27891
kroA100.tsp,steepest-ls,greedy-cycle,N2,14,12386,15198,72,27584
kroB100.tsp,greedy-ls,greedy-cycle,N1,81,11533,16511,386,28044
kroB100.tsp,steepest-ls,greedy-cycle,N2,75,10838,15443,133,26281
kroB100.tsp,steepest-ls,random-walk,N1,45,23158,17204,846,40362
kroB100.tsp,greedy-ls,greedy-cycle,N2,48,14336,10357,51,24693
kroA100.tsp,steepest-ls,greedy-cycle,N1,53,15486,12386,48,27872
kroA100.tsp,greedy-ls,random-walk,N2,26,14401,12085,237,26486
kroA100.tsp,greedy-ls,greedy-cycle,N1,9,11845,15967,23,27812
kroB100.tsp,steepest-ls,greedy-cycle,N1,65,11219,16084,80,27303
kroA100.tsp,steepest-ls,greedy-cycle,N1,1,12532,11649,95,24181
kroB100.tsp,greedy-ls,greedy-cycle,N1,58,10837,16765,20,27602
kroB100.tsp,greedy-ls,random-walk,N1,17,20587,23267,321,43854
kroB100.tsp,steepest-ls,random-walk,N2,55,15186,11702,1298,26888
kroB100.tsp,steepest-ls,random-walk,N2,100,15949,13094,380,29043
kroA100.tsp,steepest-ls,greedy-cycle,N2,43,12386,15198,67,27584
kroA100.tsp,greedy-ls,random-walk,N2,4,16055,12693,230,28748
kroB100.tsp,greedy-ls,greedy-cycle,N2,1,12068,15309,27,27377
kroA100.tsp,greedy-ls,random-walk,N1,36,25250,21943,231,47193
kroB100.tsp,steepest-ls,random-walk,N1,53,26089,14493,399,40582
kroB100.tsp,greedy-ls,random-walk,N2,11,18264,10590,203,28854
kroA100.tsp,steepest-ls,random-walk,N1,28,23428,14026,476,37454
kroB100.tsp,steepest-ls,greedy-cycle,N2,63,14317,10353,81,24670
kroB100.tsp,greedy-ls,greedy-cycle,N1,97,11194,15678,210,26872
kroB100.tsp,greedy-ls,greedy-cycle,N1,78,14993,11305,388,26298
kroA100.tsp,greedy-ls,random-walk,N2,30,16730,13461,306,30191
kroA100.tsp,steepest-ls,greedy-cycle,N1,45,14770,11657,37,26427
kroB100.tsp,steepest-ls,random-walk,N2,43,15530,12058,396,27588
kroB100.tsp,steepest-ls,greedy-cycle,N1,73,11119,15138,44,26257
kroA100.tsp,steepest-ls,random-walk,N2,38,18348,12443,345,30791
kroA100.tsp,greedy-ls,random-walk,N1,20,22414,20388,283,42802
kroA100.tsp,steepest-ls,greedy-cycle,N2,55,11713,14957,151,26670
kroA100.tsp,greedy-ls,random-walk,N2,88,14081,11664,256,25745
kroB100.tsp,steepest-ls,greedy-cycle,N2,34,10827,15415,46,26242
kroB100.tsp,greedy-ls,random-walk,N2,46,15392,13784,280,29176
kroA100.tsp,steepest-ls,greedy-cycle,N1,12,11713,15934,56,27647
kroA100.tsp,steepest-ls,random-walk,N1,90,22255,20155,498,42410
kroA100.tsp,greedy-ls,random-walk,N2,67,14431,14089,208,28520
kroA100.tsp,greedy-ls,random-walk,N1,98,17290,16984,328,34274
kroB100.tsp,steepest-ls,greedy-cycle,N1,24,15576,11305,212,26881
kroB100.tsp,greedy-ls,greedy-cycle,N1,19,15000,11305,30,26305
kroB100.tsp,greedy-ls,random-walk,N1,56,23833,16303,235,40136
kroB100.tsp,steepest-ls,random-walk,N2,14,15053,13523,540,28576
kroB100.tsp,steepest-ls,greedy-cycle,N2,100,10344,13876,96,24220
kroB100.tsp,greedy-ls,random-walk,N1,3,21055,18117,911,39172
kroA100.tsp,steepest-ls,random-walk,N2,80,15546,10189,318,25735
kroA100.tsp,greedy-ls,random-walk,N1,77,21093,19307,616,40400
kroA100.tsp,greedy-ls,greedy-cycle,N2,70,15486,12386,25,27872
kroA100.tsp,steepest-ls,greedy-cycle,N1,69,11600,14330,69,25930
kroB100.tsp,steepest-ls,random-walk,N1,90,18925,20657,642,39582
kroB100.tsp,greedy-ls,greedy-cycle,N1,54,12635,14757,217,27392
kroB100.tsp,greedy-ls,greedy-cycle,N2,72,10643,16884,60,27527
kroA100.tsp,steepest-ls,greedy-cycle,N1,86,11713,15934,52,27647
kroA100.tsp,steepest-ls,greedy-cycle,N2,79,15486,12386,83,27872
kroA100.tsp,greedy-ls,greedy-cycle,N1,60,11771,16016,24,27787
kroB100.tsp,steepest-ls,random-walk,N2,80,16641,11598,451,28239
kroA100.tsp,steepest-ls,random-walk,N2,14,16257,11867,366,28124
kroB100.tsp,greedy-ls,greedy-cycle,N1,62,10541,13854,36,24395
kroA100.tsp,steepest-ls,greedy-cycle,N2,96,11502,14424,86,25926
kroB100.tsp,greedy-ls,random-walk,N2,6,15460,14406,202,29866
kroB100.tsp,steepest-ls,random-walk,N2,8,15215,13815,586,29030
kroB100.tsp,greedy-ls,random-walk,N2,85,16305,11939,209,28244
kroA100.tsp,greedy-ls,greedy-cycle,N2,27,11713,15542,25,27255
kroB100.tsp,greedy-ls,greedy-cycle,N2,25,10827,15593,29,26420
kroB100.tsp,steepest-ls,random-walk,N1,28,23465,15489,628,38954
kroA100.tsp,steepest-ls,random-walk,N1,53,22968,23212,403,46180
kroB100.tsp,steepest-ls,greedy-cycle,N2,18,14384,11305,49,25689
kroB100.tsp,greedy-ls,random-walk,N1,95,24440,15872,233,40312
kroA100.tsp,greedy-ls,greedy-cycle,N1,37,11502,15437,29,26939
kroB100.tsp,steepest-ls,random-walk,N2,38,15939,12639,506,28578
kroB100.tsp,greedy-ls,greedy-cycle,N1,35,10827,16739,13,27566
kroA100.tsp,steepest-ls,random-walk,N2,43,16265,11790,289,28055
kroA100.tsp,steepest-ls,greedy-cycle,N1,28,13148,12828,122,25976
kroA100.tsp,greedy-ls,greedy-cycle,N2,31,11959,11629,55,23588
kroB100.tsp,greedy-ls,random-walk,N2,93,15987,10763,256,26750
kroB100.tsp,greedy-ls,greedy-cycle,N1,15,14317,10617,261,24934
kroA100.tsp,steepest-ls,random-walk,N1,45,22460,22658,717,45118
kroB100.tsp,greedy-ls,greedy-cycle,N2,33,14317,10353,28,24670
kroA100.tsp,greedy-ls,greedy-cycle,N1,21,14581,11657,27,26238
kroA100.tsp,steepest-ls,greedy-cycle,N2,38,14435,11657,42,26092
kroB100.tsp,greedy-ls,random-walk,N1,83,21879,16621,223,38500
kroA100.tsp,steepest-ls,random-walk,N2,55,15238,12317,305,27555
kroB100.tsp,greedy-ls,greedy-cycle,N1,23,15267,11907,30,27174
kroB100.tsp,steepest-ls,greedy-cycle,N1,1,12212,15896,122,28108
kroB100.tsp,greedy-ls,greedy-cycle,N1,42,14408,10982,411,25390
kroB100.tsp,steepest-ls,random-walk,N1,86,24926,18606,686,43532
kroA100.tsp,steepest-ls,greedy-cycle,N2,4,15198,12386,64,27584
kroA100.tsp,greedy-ls,greedy-cycle,N2,66,15198,12386,58,27584
kroA100.tsp,greedy-ls,greedy-cycle,N2,89,11860,11011,69,22871
kroA100.tsp,steepest-ls,greedy-cycle,N1,90,15513,12386,61,27899
kroA100.tsp,greedy-ls,random-walk,N1,1,23390,16915,1572,40305
kroB100.tsp,greedy-ls,greedy-cycle,N1,4,14317,10954,25,25271
kroB100.tsp,greedy-ls,greedy-cycle,N2,64,14338,10331,49,24669
kroB100.tsp,steepest-ls,random-walk,N1,69,22244,17453,484,39697
kroB100.tsp,steepest-ls,greedy-cycle,N2,59,11194,14354,116,25548
kroA100.tsp,steepest-ls,random-walk,N1,12,20699,18533,471,39232
kroB100.tsp,steepest-ls,random-walk,N2,96,14915,13459,461,28374
kroA100.tsp,greedy-ls,greedy-cycle,N1,76,11657,14581,21,26238
kroA100.tsp,steepest-ls,greedy-cycle,N2,80,11860,10969,162,22829
kroA100.tsp,greedy-ls,greedy-cycle,N1,99,14581,11657,20,26238
kroB100.tsp,steepest-ls,random-walk,N2,79,14474,11331,419,25805
kroB100.tsp,greedy-ls,greedy-cycle,N1,74,12268,13868,34,26136
kroB100.tsp,steepest-ls,greedy-cycle,N1,49,11027,15534,104,26561
kroA100.tsp,greedy-ls,random-walk,N1,82,20750,25181,287,45931
kroA100.tsp,steepest-ls,random-walk,N2,75,14201,12817,353,27018
kroA100.tsp,steepest-ls,greedy-cycle,N2,18,14147,11657,85,25804
kroA100.tsp,greedy-ls,random-walk,N2,92,14367,10255,218,24622
kroA100.tsp,steepest-ls,random-walk,N1,65,25969,18355,509,44324
kroB100.tsp,greedy-ls,greedy-cycle,N2,13,14317,10353,32,24670
kroA100.tsp,greedy-ls,greedy-cycle,N2,11,14435,11657,20,26092
kroB100.tsp,steepest-ls,greedy-cycle,N2,8,11194,14354,68,25548
kroB100.tsp,greedy-ls,greedy-cycle,N1,35,10827,16739,127,27566
kroB100.tsp,steepest-ls,random-walk,N2,59,13785,11676,403,25461
kroB100.tsp,greedy-ls,greedy-cycle,N1,54,12635,14757,33,27392
kroA100.tsp,steepest-ls,random-walk,N2,22,15640,11805,329,27445
kroB100.tsp,steepest-ls,greedy-cycle,N1,69,10730,14227,215,24957
kroB100.tsp,steepest-ls,greedy-cycle,N1,86,11027,15534,164,26561
kroA100.tsp,greedy-ls,random-walk,N2,8,16411,10693,219,27104
kroA100.tsp,greedy-ls,greedy-cycle,N1,56,15198,12386,27,27584
kroB100.tsp,greedy-ls,greedy-cycle,N2,44,14108,11444,26,25552
kroB100.tsp,steepest-ls,random-walk,N1,49,22532,21788,496,44320
kroB100.tsp,steepest-ls,greedy-cycle,N2,79,11505,16324,114,27829
kroA100.tsp,steepest-ls,random-walk,N1,32,23145,17651,822,40796
kroA100.tsp,greedy-ls,greedy-cycle,N1,5,11502,15437,25,26939
kroB100.tsp,greedy-ls,greedy-cycle,N1,62,11010,15938,554,26948
kroB100.tsp,steepest-ls,greedy-cycle,N2,96,14206,11305,88,25511
kroA100.tsp,greedy-ls,greedy-cycle,N2,46,12386,15198,18,27584
kroA100.tsp,steepest-ls,random-walk,N2,34,13999,10920,339,24919
kroB100.tsp,greedy-ls,greedy-cycle,N1,42,14295,10617,53,24912
kroA100.tsp,steepest-ls,greedy-cycle,N2,59,14147,11657,81,25804
kroA100.tsp,greedy-ls,greedy-cycle,N1,40,11600,14330,44,25930
kroB100.tsp,steepest-ls,greedy-cycle,N1,90,12212,15896,61,28108
kroA100.tsp,steepest-ls,random-walk,N1,24,24772,21790,497,46562
kroB100.tsp,greedy-ls,greedy-cycle,N2,52,12537,14523,21,27060
kroA100.tsp,greedy-ls,greedy-cycle,N2,50,11600,14076,37,25676
kroA100.tsp,steepest-ls,greedy-cycle,N1,49,15513,12386,44,27899
kroB100.tsp,steepest-ls,greedy-cycle,N2,80,10838,15443,151,26281
kroB100.tsp,greedy-ls,greedy-cycle,N1,74,12450,13678,656,26128
kroB100.tsp,steepest-ls,random-walk,N1,1,23969,21236,808,45205
kroB100.tsp,steepest-ls,random-walk,N2,18,15263,12813,737,28076
kroB100.tsp,greedy-ls,greedy-cycle,N1,15,14429,10741,24,25170
kroB100.tsp,steepest-ls,greedy-cycle,N1,28,11205,15678,61,26883
kroA100.tsp,steepest-ls,random-walk,N2,63,15249,12145,276,27394
kroA100.tsp,greedy-ls,random-walk,N1,94,24220,16009,696,40229
kroA100.tsp,steepest-ls,random-walk,N1,3,18626,22743,1381,41369
kroA100.tsp,greedy-ls,greedy-cycle,N1,17,14763,11657,22,26420
kroA100.tsp,steepest-ls,random-walk,N1,73,21556,21248,446,42804
kroB100.tsp,steepest-ls,greedy-cycle,N2,38,10838,15443,70,26281
kroA100.tsp,greedy-ls,random-walk,N2,84,15596,12776,265,28372
kroB100.tsp,greedy-ls,greedy-cycle,N1,23,15301,11907,308,27208
kroB100.tsp,greedy-ls,greedy-cycle,N1,81,11478,16714,34,28192
kroA100.tsp,steepest-ls,greedy-cycle,N2,75,15198,12386,61,27584
kroA100.tsp,greedy-ls,greedy-cycle,N1,83,11713,15934,25,27647
kroB100.tsp,greedy-ls,random-walk,N1,21,27631,18810,291,46441
kroB100.tsp,steepest-ls,random-walk,N2,63,17548,14206,433,31754
kroB100.tsp,steepest-ls,greedy-cycle,N1,53,10342,16742,45,27084
kroA100.tsp,steepest-ls,random-walk,N2,18,16980,10637,309,27617
kroA100.tsp,greedy-ls,random-walk,N1,100,24706,15864,247,40570
kroB100.tsp,greedy-ls,greedy-cycle,N1,58,10837,16765,375,27602
kroA100.tsp,greedy-ls,random-walk,N2,10,13359,12861,432,26220
kroA100.tsp,steepest-ls,random-walk,N2,100,16163,12524,302,28687
kroB100.tsp,greedy-ls,greedy-cycle,N2,91,11194,14486,42,25680
kroA100.tsp,steepest-ls,greedy-cycle,N1,65,15198,12386,56,27584
kroA100.tsp,greedy-ls,greedy-cycle,N2,93,12016,13870,10,25886
kroB100.tsp,steepest-ls,random-walk,N1,73,27523,19528,361,47051
kroB100.tsp,greedy-ls,random-walk,N2,31,17064,11722,385,28786
kroB100.tsp,steepest-ls,greedy-cycle,N2,43,12450,13601,61,26051
kroA100.tsp,steepest-ls,greedy-cycle,N2,22,15486,12386,113,27872
kroB100.tsp,greedy-ls,random-walk,N1,99,21365,16535,214,37900
kroA100.tsp,greedy-ls,random-walk,N1,57,22402,17909,241,40311
kroB100.tsp,greedy-ls,greedy-cycle,N1,39,10342,16629,23,26971
kroB100.tsp,greedy-ls,random-walk,N1,76,25337,18734,239,44071
kroB100.tsp,steepest-ls,random-walk,N2,34,15927,12333,666,28260
kroA100.tsp,steepest-ls,greedy-cycle,N1,32,14763,11657,54,26420
kroB100.tsp,greedy-ls,random-walk,N2,89,15664,12196,205,27860
kroB100.tsp,steepest-ls,random-walk,N2,4,15190,12965,352,28155
kroA100.tsp,greedy-ls,random-walk,N2,47,18258,10665,1251,28923
kroB100.tsp,greedy-ls,greedy-cycle,N1,7,10826,16765,126,27591
kroA100.tsp,steepest-ls,random-walk,N2,6,15314,10077,342,25391
kroB100.tsp,steepest-ls,greedy-cycle,N2,14,14017,10353,75,24370
kroB100.tsp,steepest-ls,random-walk,N1,24,27138,20265,481,47403
kroB100.tsp,greedy-ls,random-walk,N2,66,13100,14877,324,27977
kroB100.tsp,greedy-ls,greedy-cycle,N2,29,11194,14354,34,25548
kroA100.tsp,greedy-ls,random-walk,N1,41,19949,20611,229,40560
kroA100.tsp,steepest-ls,greedy-cycle,N2,34,11713,14957,159,26670
kroB100.tsp,greedy-ls,random-walk,N1,60,19183,14642,304,33825
kroB100.tsp,steepest-ls,random-walk,N2,22,14480,12520,274,27000
kroA100.tsp,steepest-ls,random-walk,N2,59,16819,11019,361,27838
kroB100.tsp,steepest-ls,greedy-cycle,N1,12,11205,15678,64,26883
kroB100.tsp,greedy-ls,greedy-cycle,N1,19,15770,11825,167,27595
kroA100.tsp,greedy-ls,random-walk,N2,51,15082,12632,632,27714
kroA100.tsp,steepest-ls,greedy-cycle,N1,24,14595,11657,43,26252
kroB100.tsp,steepest-ls,random-walk,N1,32,20833,19658,1849,40491
kroB100.tsp,greedy-ls,random-walk,N2,70,17378,13024,491,30402
kroA100.tsp,steepest-ls,random-walk,N1,49,29040,17884,480,46924
kroA100.tsp,steepest-ls,greedy-cycle,N2,63,13943,11657,40,25600
kroB100.tsp,greedy-ls,greedy-cycle,N1,97,11261,15678,25,26939
kroA100.tsp,greedy-ls,random-walk,N1,16,19031,17790,352,36821
kroB100.tsp,steepest-ls,greedy-cycle,N1,45,16692,10859,73,27551
kroB100.tsp,greedy-ls,greedy-cycle,N1,78,15361,11867,14,27228
kroB100.tsp,greedy-ls,random-walk,N1,37,19814,20813,421,40627
kroB100.tsp,steepest-ls,random-walk,N2,75,17145,12411,525,29556
kroA100.tsp,greedy-ls,greedy-cycle,N1,95,11657,14581,20,26238
kroA100.tsp,steepest-ls,greedy-cycle,N2,8,14813,12784,69,27597
kroA100.tsp,steepest-ls,greedy-cycle,N1,73,11600,14330,81,25930
kroB100.tsp,greedy-ls,greedy-cycle,N2,87,12400,13791,103,26191
kroB100.tsp,steepest-ls,greedy-cycle,N2,55,14968,11907,85,26875
kroB100.tsp,steepest-ls,random-walk,N1,65,21211,18591,693,39802
kroB100.tsp,greedy-ls,random-walk,N2,27,16330,12576,372,28906
kroB100.tsp,greedy-ls,greedy-cycle,N1,8,11194,15678,20,26872
kroB100.tsp,greedy-ls,greedy-cycle,N2,68,11222,16014,48,27236
kroA100.tsp,greedy-ls,greedy-cycle,N2,85,11502,14427,54,25929
kroA100.tsp,steepest-ls,greedy-cycle,N1,72,14581,11657,39,26238
kroA100.tsp,steepest-ls,greedy-cycle,N2,9,11713,14957,172,26670
kroB100.tsp,greedy-ls,greedy-cycle,N2,86,10353,15862,140,26215
kroB100.tsp,steepest-ls,greedy-cycle,N2,54,12420,14523,82,26943
kroB100.tsp,steepest-ls,random-walk,N1,64,23339,22607,768,45946
kroB100.tsp,greedy-ls,random-walk,N2,26,16086,12863,450,28949
kroB100.tsp,greedy-ls,greedy-cycle,N1,9,10827,16739,9,27566
kroB100.tsp,greedy-ls,greedy-cycle,N2,69,10342,15503,47,25845
kroA100.tsp,greedy-ls,greedy-cycle,N2,84,14435,11657,34,26092
kroA100.tsp,steepest-ls,greedy-cycle,N2,62,11876,15476,40,27352
kroB100.tsp,greedy-ls,greedy-cycle,N1,96,16148,11305,16,27453
kroA100.tsp,greedy-ls,random-walk,N1,17,19090,13701,373,32791
kroB100.tsp,steepest-ls,greedy-cycle,N1,44,15120,11444,67,26564
kroB100.tsp,greedy-ls,greedy-cycle,N1,79,11478,16714,39,28192
kroB100.tsp,greedy-ls,random-walk,N1,36,18691,13510,615,32201
kroB100.tsp,steepest-ls,random-walk,N2,74,14489,13480,293,27969
kroA100.tsp,greedy-ls,greedy-cycle,N2,1,12532,11703,31,24235
kroA100.tsp,greedy-ls,greedy-cycle,N1,94,15486,12386,29,27872
kroB100.tsp,greedy-ls,greedy-cycle,N1,18,14697,11305,265,26002
kroA100.tsp,greedy-ls,random-walk,N2,50,16294,11245,758,27539
kroA100.tsp,steepest-ls,greedy-cycle,N1,25,11698,16222,50,27920
kroB100.tsp,steepest-ls,random-walk,N1,33,22900,21265,771,44165
kroB100.tsp,greedy-ls,random-walk,N2,71,16253,11000,245,27253
kroA100.tsp,steepest-ls,random-walk,N1,48,23180,20795,369,43975
kroA100.tsp,greedy-ls,random-walk,N1,40,21911,19115,245,41026
kroA100.tsp,steepest-ls,greedy-cycle,N2,35,11713,14957,99,26670
kroB100.tsp,greedy-ls,random-walk,N1,61,22035,14806,280,36841
kroB100.tsp,steepest-ls,random-walk,N2,23,18065,12554,312,30619
kroA100.tsp,steepest-ls,random-walk,N2,58,16002,11453,319,27455
kroB100.tsp,steepest-ls,greedy-cycle,N1,13,15054,10577,113,25631
kroA100.tsp,steepest-ls,greedy-cycle,N1,33,11657,14581,132,26238
kroB100.tsp,greedy-ls,random-walk,N2,88,17257,13398,256,30655
kroA100.tsp,steepest-ls,greedy-cycle,N2,100,12386,15198,303,27584
kroB100.tsp,steepest-ls,random-walk,N2,5,15763,11382,1066,27145
kroA100.tsp,greedy-ls,random-walk,N2,46,14973,11014,1474,25987
kroB100.tsp,greedy-ls,greedy-cycle,N1,6,14317,10617,349,24934
kroA100.tsp,steepest-ls,random-walk,N2,7,14173,9881,317,24054
kroB100.tsp,steepest-ls,greedy-cycle,N2,15,14317,10353,68,24670
kroB100.tsp,steepest-ls,random-walk,N1,25,21125,19383,368,40508
kroB100.tsp,greedy-ls,random-walk,N2,67,15840,12080,225,27920
kroB100.tsp,greedy-ls,greedy-cycle,N2,28,11194,14653,23,25847
kroA100.tsp,steepest-ls,greedy-cycle,N2,23,14435,11657,73,26092
kroB100.tsp,greedy-ls,random-walk,N1,98,22596,16344,200,38940
kroA100.tsp,greedy-ls,random-walk,N1,56,22723,18164,351,40887
kroB100.tsp,greedy-ls,greedy-cycle,N1,38,11250,15302,42,26552
kroB100.tsp,greedy-ls,random-walk,N1,77,26901,21252,218,48153
kroB100.tsp,steepest-ls,random-walk,N2,35,15418,12594,571,28012
kroB100.tsp,greedy-ls,greedy-cycle,N1,59,11205,15678,383,26883
kroA100.tsp,greedy-ls,random-walk,N2,11,17479,11983,312,29462
kroB100.tsp,greedy-ls,greedy-cycle,N2,90,11437,15192,45,26629
kroA100.tsp,steepest-ls,greedy-cycle,N1,64,11600,14330,70,25930
kroA100.tsp,greedy-ls,greedy-cycle,N2,92,11860,11119,41,22979
kroB100.tsp,steepest-ls,random-walk,N1,72,19695,20674,530,40369
kroB100.tsp,greedy-ls,random-walk,N2,30,14688,9901,215,24589
kroB100.tsp,steepest-ls,greedy-cycle,N2,42,14317,10353,46,24670
kroB100.tsp,greedy-ls,greedy-cycle,N1,80,11251,14998,43,26249
kroA100.tsp,steepest-ls,greedy-cycle,N2,74,14147,11657,95,25804
kroA100.tsp,greedy-ls,greedy-cycle,N1,82,11657,14581,17,26238
kroB100.tsp,greedy-ls,random-walk,N1,20,21919,17288,248,39207
kroB100.tsp,steepest-ls,random-walk,N2,62,13438,14513,618,27951
kroB100.tsp,steepest-ls,greedy-cycle,N1,52,12635,14757,96,27392
kroA100.tsp,steepest-ls,random-walk,N2,19,13883,12467,328,26350
kroA100.tsp,steepest-ls,random-walk,N1,72,20464,17901,387,38365
kroB100.tsp,steepest-ls,greedy-cycle,N2,39,10153,16651,24,26804
kroA100.tsp,greedy-ls,random-walk,N2,85,14190,13360,242,27550
kroB100.tsp,greedy-ls,greedy-cycle,N1,22,15252,11907,415,27159
kroB100.tsp,steepest-ls,random-walk,N2,19,15353,12847,369,28200
kroB100.tsp,greedy-ls,greedy-cycle,N1,14,15011,10771,50,25782
kroB100.tsp,steepest-ls,greedy-cycle,N1,29,11205,15678,85,26883
kroA100.tsp,steepest-ls,random-walk,N2,62,14286,13736,300,28022
kroA100.tsp,greedy-ls,random-walk,N1,95,20107,16816,649,36923
kroA100.tsp,steepest-ls,random-walk,N1,2,22162,22761,487,44923
kroA100.tsp,greedy-ls,greedy-cycle,N1,16,15489,12386,22,27875
kroA100.tsp,steepest-ls,random-walk,N1,25,24196,22127,574,46323
kroB100.tsp,greedy-ls,greedy-cycle,N2,53,10153,16783,19,26936
kroA100.tsp,steepest-ls,greedy-cycle,N1,48,12386,15198,53,27584
kroA100.tsp,greedy-ls,greedy-cycle,N2,51,11551,13366,46,24917
kroB100.tsp,steepest-ls,greedy-cycle,N2,81,11505,16324,140,27829
kroB100.tsp,greedy-ls,greedy-cycle,N1,75,11250,15415,733,26665
kroA100.tsp,steepest-ls,random-walk,N2,35,16228,14299,343,30527
kroB100.tsp,greedy-ls,greedy-cycle,N1,43,12440,14532,26,26972
kroA100.tsp,greedy-ls,greedy-cycle,N1,41,12386,15198,112,27584
kroA100.tsp,steepest-ls,greedy-cycle,N2,58,11480,14136,64,25616
kroB100.tsp,steepest-ls,greedy-cycle,N1,91,11205,15678,59,26883
kroB100.tsp,greedy-ls,greedy-cycle,N2,45,16084,10859,33,26943
kroB100.tsp,steepest-ls,random-walk,N1,48,21065,20921,485,41986
kroB100.tsp,steepest-ls,greedy-cycle,N2,78,14384,11305,91,25689
kroA100.tsp,steepest-ls,random-walk,N1,33,24245,17538,507,41783
kroA100.tsp,greedy-ls,greedy-cycle,N1,4,15198,12386,19,27584
kroB100.tsp,greedy-ls,greedy-cycle,N1,63,14408,10954,310,25362
kroB100.tsp,steepest-ls,greedy-cycle,N2,97,11194,14354,77,25548
kroA100.tsp,greedy-ls,greedy-cycle,N2,47,14123,11657,18,25780
kroB100.tsp,steepest-ls,random-walk,N2,58,16585,12813,442,29398
kroB100.tsp,greedy-ls,greedy-cycle,N1,55,15681,11733,43,27414
kroA100.tsp,steepest-ls,random-walk,N2,23,16102,11435,314,27537
kroB100.tsp,steepest-ls,greedy-cycle,N1,68,11909,16449,85,28358
kroA100.tsp,greedy-ls,random-walk,N2,9,12034,12613,236,24647
kroB100.tsp,steepest-ls,greedy-cycle,N1,87,12450,13865,87,26315
kroA100.tsp,greedy-ls,greedy-cycle,N1,57,11713,15934,29,27647
kroA100.tsp,greedy-ls,random-walk,N2,93,15169,11325,260,26494
kroA100.tsp,steepest-ls,random-walk,N1,64,21486,23305,389,44791
kroB100.tsp,greedy-ls,greedy-cycle,N2,12,11194,14475,28,25669
kroA100.tsp,greedy-ls,greedy-cycle,N2,10,14178,11657,26,25835
kroB100.tsp,steepest-ls,greedy-cycle,N2,9,10827,15415,66,26242
kroB100.tsp,greedy-ls,greedy-cycle,N1,34,10827,16739,113,27566
kroA100.tsp,greedy-ls,random-walk,N1,83,23385,19932,392,43317
kroA100.tsp,steepest-ls,random-walk,N2,74,16372,13705,335,30077
kroA100.tsp,steepest-ls,greedy-cycle,N2,19,15198,12386,59,27584
kroB100.tsp,steepest-ls,random-walk,N2,97,14833,12648,675,27481
kroA100.tsp,greedy-ls,greedy-cycle,N1,77,11915,15550,20,27465
kroA100.tsp,greedy-ls,greedy-cycle,N1,98,14763,11657,16,26420
kroA100.tsp,steepest-ls,greedy-cycle,N2,81,11698,15245,93,26943
kroB100.tsp,steepest-ls,random-walk,N2,78,15087,13308,490,28395
kroB100.tsp,greedy-ls,greedy-cycle,N1,75,11250,15415,25,26665
kroB100.tsp,steepest-ls,greedy-cycle,N1,48,14408,10577,605,24985
kroB100.tsp,greedy-ls,greedy-cycle,N1,43,12440,14345,549,26785
kroB100.tsp,steepest-ls,random-walk,N1,87,21736,18485,477,40221
kroA100.tsp,steepest-ls,greedy-cycle,N2,5,11502,14424,102,25926
kroA100.tsp,greedy-ls,greedy-cycle,N2,67,13148,12676,23,25824
kroA100.tsp,steepest-ls,greedy-cycle,N1,91,14770,11657,34,26427
kroA100.tsp,greedy-ls,greedy-cycle,N2,88,15489,12386,29,27875
kroB100.tsp,greedy-ls,greedy-cycle,N1,5,10288,16742,21,27030
kroB100.tsp,greedy-ls,greedy-cycle,N2,65,11283,16605,35,27888
kroB100.tsp,steepest-ls,random-walk,N1,68,23155,17867,501,41022
kroB100.tsp,steepest-ls,greedy-cycle,N2,58,10837,15384,103,26221
kroA100.tsp,steepest-ls,random-walk,N1,13,22947,25810,622,48757
kroA100.tsp,steepest-ls,greedy-cycle,N2,39,12333,15083,96,27416
kroA100.tsp,greedy-ls,greedy-cycle,N1,20,11669,16156,35,27825
kroB100.tsp,greedy-ls,random-walk,N1,82,25577,15597,201,41174
kroA100.tsp,steepest-ls,random-walk,N2,54,15449,11199,298,26648
kroB100.tsp,greedy-ls,greedy-cycle,N1,22,15267,11907,41,27174
kroA100.tsp,greedy-ls,greedy-cycle,N2,30,12333,15086,20,27419
kroA100.tsp,steepest-ls,greedy-cycle,N1,29,12386,15198,49,27584
kroB100.tsp,greedy-ls,random-walk,N2,92,16778,12279,400,29057
kroB100.tsp,greedy-ls,greedy-cycle,N1,14,14899,11871,226,26770
kroA100.tsp,steepest-ls,random-walk,N1,44,24214,21116,628,45330
kroB100.tsp,greedy-ls,greedy-cycle,N2,32,11194,14532,68,25726
kroB100.tsp,greedy-ls,random-walk,N1,94,25293,16835,227,42128
kroA100.tsp,greedy-ls,greedy-cycle,N1,36,14581,11657,19,26238
kroB100.tsp,steepest-ls,random-walk,N2,39,15474,13774,718,29248
kroB100.tsp,greedy-ls,greedy-cycle,N1,34,10827,16739,21,27566
kroA100.tsp,steepest-ls,random-walk,N2,42,15327,12143,307,27470
kroB100.tsp,greedy-ls,random-walk,N2,7,14673,12719,214,27392
kroB100.tsp,steepest-ls,random-walk,N2,9,15506,12522,407,28028
kroB100.tsp,greedy-ls,random-walk,N2,84,16046,10867,446,26913
kroA100.tsp,greedy-ls,greedy-cycle,N2,26,15198,12386,25,27584
kroB100.tsp,greedy-ls,greedy-cycle,N2,24,14525,11825,34,26350
kroB100.tsp,steepest-ls,random-walk,N1,29,21686,23185,1263,44871
kroA100.tsp,steepest-ls,random-walk,N1,52,19138,21856,504,40994
kroB100.tsp,steepest-ls,greedy-cycle,N2,19,14206,11305,57,25511
kroA100.tsp,greedy-ls,greedy-cycle,N1,61,11551,13815,54,25366
kroA100.tsp,steepest-ls,greedy-cycle,N2,78,11502,14424,164,25926
kroB100.tsp,steepest-ls,random-walk,N2,81,13879,10895,529,24774
kroA100.tsp,steepest-ls,random-walk,N2,15,15457,12542,331,27999
kroB100.tsp,greedy-ls,greedy-cycle,N1,63,14295,11326,37,25621
kroA100.tsp,steepest-ls,greedy-cycle,N2,97,15198,12386,111,27584
kroA100.tsp,steepest-ls,greedy-cycle,N1,68,11502,15434,51,26936
kroA100.tsp,greedy-ls,greedy-cycle,N2,71,12386,15198,22,27584
kroB100.tsp,steepest-ls,random-walk,N1,91,22533,18116,859,40649
kroB100.tsp,greedy-ls,greedy-cycle,N1,55,15350,11907,262,27257
kroB100.tsp,greedy-ls,greedy-cycle,N2,73,11108,14124,68,25232
kroA100.tsp,steepest-ls,greedy-cycle,N1,87,11698,15934,48,27632
kroA100.tsp,greedy-ls,random-walk,N1,99,22270,18325,292,40595
kroB100.tsp,steepest-ls,greedy-cycle,N1,25,10827,16739,27,27566
kroB100.tsp,greedy-ls,greedy-cycle,N1,18,14697,11222,36,25919
kroB100.tsp,greedy-ls,random-walk,N1,2,23674,19505,579,43179
kroB100.tsp,greedy-ls,random-walk,N1,57,25613,17359,223,42972
kroB100.tsp,steepest-ls,random-walk,N2,15,16224,11130,345,27354
kroA100.tsp,steepest-ls,random-walk,N2,81,14503,11594,290,26097
kroA100.tsp,greedy-ls,random-walk,N1,76,23167,18417,753,41584
kroA100.tsp,greedy-ls,random-walk,N2,89,16431,14522,272,30953
kroB100.tsp,steepest-ls,greedy-cycle,N2,35,10827,15415,55,26242
kroB100.tsp,greedy-ls,random-walk,N2,47,17425,13120,424,30545
kroA100.tsp,steepest-ls,greedy-cycle,N1,13,11657,14581,42,26238
kroA100.tsp,steepest-ls,random-walk,N1,91,24614,18673,339,43287
kroA100.tsp,greedy-ls,random-walk,N2,66,14723,13326,246,28049
kroB100.tsp,steepest-ls,random-walk,N2,42,16166,13674,398,29840
kroB100.tsp,steepest-ls,greedy-cycle,N1,72,11316,17195,46,28511
kroA100.tsp,steepest-ls,random-walk,N2,39,16534,11375,324,27909
kroA100.tsp,greedy-ls,random-walk,N1,21,20126,18289,301,38415
kroA100.tsp,steepest-ls,greedy-cycle,N2,54,11502,14991,72,26493
kroB100.tsp,steepest-ls,random-walk,N1,52,20835,15652,557,36487
kroB100.tsp,greedy-ls,random-walk,N2,10,15950,10491,198,26441
kroA100.tsp,steepest-ls,random-walk,N1,29,19923,20162,538,40085
kroB100.tsp,steepest-ls,greedy-cycle,N2,62,10344,13876,108,24220
kroB100.tsp,greedy-ls,greedy-cycle,N1,96,15378,11867,552,27245
kroB100.tsp,greedy-ls,greedy-cycle,N1,79,11478,16714,537,28192
kroA100.tsp,greedy-ls,random-walk,N2,31,16248,13357,252,29605
kroA100.tsp,steepest-ls,greedy-cycle,N1,44,11600,14330,72,25930
kroB100.tsp,steepest-ls,greedy-cycle,N1,64,14899,10763,112,25662
kroB100.tsp,greedy-ls,greedy-cycle,N1,59,11205,15678,30,26883
kroB100.tsp,greedy-ls,random-walk,N1,16,19869,13614,391,33483
kroB100.tsp,steepest-ls,random-walk,N2,54,17325,11018,375,28343
kroA100.tsp,steepest-ls,greedy-cycle,N2,42,11860,10969,149,22829
kroA100.tsp,greedy-ls,random-walk,N2,5,15005,13401,432,28406
kroA100.tsp,greedy-ls,random-walk,N1,37,19355,21517,260,40872
kroB100.tsp,greedy-ls,greedy-cycle,N1,80,11027,15534,497,26561
kroB100.tsp,steepest-ls,greedy-cycle,N2,74,12450,13601,73,26051
kroB100.tsp,steepest-ls,random-walk,N1,44,28712,20226,740,48938
kroB100.tsp,greedy-ls,greedy-cycle,N2,49,10191,15224,36,25415
kroA100.tsp,steepest-ls,greedy-cycle,N1,52,11502,15434,49,26936
kroA100.tsp,greedy-ls,random-walk,N2,27,13496,13434,208,26930
kroA100.tsp,greedy-ls,greedy-cycle,N1,8,14813,12784,18,27597
kroB100.tsp,greedy-ls,random-walk,N1,41,20581,19815,224,40396
kroA100.tsp,steepest-ls,random-walk,N2,78,15980,11720,359,27700
kroB100.tsp,steepest-ls,greedy-cycle,N1,33,14317,10763,52,25080
kroA100.tsp,greedy-ls,random-walk,N1,60,21871,19973,326,41844
kroA100.tsp,steepest-ls,random-walk,N2,97,15593,12462,326,28055
kroA100.tsp,steepest-ls,greedy-cycle,N2,15,14435,11657,104,26092
kroB100.tsp,steepest-ls,random-walk,N1,13,21386,22961,430,44347
kroB100.tsp,greedy-ls,random-walk,N2,51,14348,11000,249,25348
kroB100.tsp,steepest-ls,greedy-cycle,N2,23,14968,11907,47,26875
kroA100.tsp,steepest-ls,random-walk,N1,68,22389,16618,497,39007
kroB100.tsp,greedy-ls,greedy-cycle,N1,38,11250,15302,304,26552
kroB100.tsp,steepest-ls,greedy-cycle,N2,5,10099,16651,32,26750
kroA100.tsp,greedy-ls,random-walk,N2,70,15833,11813,340,27646
kroA100.tsp,steepest-ls,random-walk,N1,87,23279,24647,423,47926
kroA100.tsp,steepest-ls,greedy-cycle,N2,82,11657,14435,47,26092
kroB100.tsp,greedy-ls,random-walk,N1,39,21338,20352,302,41690
kroB100.tsp,greedy-ls,greedy-cycle,N1,76,11194,15678,26,26872
kroB100.tsp,steepest-ls,random-walk,N2,94,17333,12062,404,29395
kroB100.tsp,greedy-ls,greedy-cycle,N1,99,11194,15678,22,26872
kroA100.tsp,greedy-ls,greedy-cycle,N1,74,14595,11657,15,26252
kroA100.tsp,greedy-ls,random-walk,N1,18,19090,14455,328,33545
kroA100.tsp,steepest-ls,random-walk,N1,10,18482,19484,414,37966
kroA100.tsp,steepest-ls,greedy-cycle,N1,92,11860,11668,91,23528
kroA100.tsp,greedy-ls,random-walk,N1,3,19510,19911,734,39421
kroB100.tsp,greedy-ls,greedy-cycle,N2,66,13248,12839,29,26087
kroB100.tsp,greedy-ls,greedy-cycle,N1,6,14204,11126,27,25330
kroB100.tsp,greedy-ls,random-walk,N2,29,16831,13679,304,30510
kroB100.tsp,greedy-ls,greedy-cycle,N2,89,12268,13791,50,26059
kroB100.tsp,steepest-ls,random-walk,N1,84,23167,20046,643,43213
kroA100.tsp,greedy-ls,greedy-cycle,N2,64,11696,16215,47,27911
kroA100.tsp,steepest-ls,greedy-cycle,N2,6,15513,12386,50,27899
kroB100.tsp,greedy-ls,greedy-cycle,N1,40,10342,16629,191,26971
kroB100.tsp,steepest-ls,greedy-cycle,N1,3,11119,15138,63,26257
kroB100.tsp,greedy-ls,greedy-cycle,N1,21,12191,16227,24,28418
kroA100.tsp,steepest-ls,random-walk,N2,57,13974,14399,456,28373
kroA100.tsp,greedy-ls,greedy-cycle,N1,23,14770,11657,22,26427
kroB100.tsp,greedy-ls,random-walk,N1,81,17703,17565,289,35268
kroB100.tsp,greedy-ls,greedy-cycle,N2,31,13804,9850,32,23654
kroA100.tsp,steepest-ls,random-walk,N1,47,24293,17456,443,41749
kroB100.tsp,greedy-ls,greedy-cycle,N1,17,16490,10859,446,27349
kroA100.tsp,greedy-ls,greedy-cycle,N2,33,11657,14435,29,26092
kroB100.tsp,greedy-ls,random-walk,N2,91,14535,12468,283,27003
kroA100.tsp,steepest-ls,random-walk,N2,41,14392,11641,337,26033
kroB100.tsp,greedy-ls,random-walk,N1,78,19170,25314,225,44484
kroB100.tsp,greedy-ls,greedy-cycle,N1,37,11316,17195,30,28511
kroB100.tsp,greedy-ls,random-walk,N1,97,21689,18616,195,40305
kroA100.tsp,greedy-ls,greedy-cycle,N1,35,11713,15934,24,27647
kroA100.tsp,greedy-ls,random-walk,N1,59,23793,17203,267,40996
kroA100.tsp,steepest-ls,random-walk,N1,51,25163,18073,416,43236
kroA100.tsp,steepest-ls,random-walk,N2,8,15455,11941,350,27396
kroB100.tsp,greedy-ls,greedy-cycle,N2,27,10827,15415,17,26242
kroB100.tsp,greedy-ls,random-walk,N2,68,15781,12270,228,28051
kroB100.tsp,greedy-ls,random-walk,N2,87,17438,13430,257,30868
kroA100.tsp,greedy-ls,greedy-cycle,N2,25,11830,15646,29,27476
kroB100.tsp,greedy-ls,greedy-cycle,N1,9,10827,16739,168,27566
kroB100.tsp,greedy-ls,random-walk,N2,4,14609,14462,182,29071
kroA100.tsp,greedy-ls,random-walk,N2,49,14472,12254,775,26726
kroB100.tsp,greedy-ls,greedy-cycle,N1,60,12450,13678,41,26128
kroA100.tsp,steepest-ls,greedy-cycle,N2,94,15486,12386,49,27872
kroA100.tsp,steepest-ls,random-walk,N2,16,14491,11779,713,26270
kroA100.tsp,greedy-ls,greedy-cycle,N1,62,11762,15630,30,27392
kroB100.tsp,steepest-ls,random-walk,N2,82,16255,12563,396,28818
kroB100.tsp,greedy-ls,greedy-cycle,N2,70,10153,16670,33,26823
kroA100.tsp,steepest-ls,greedy-cycle,N1,84,14581,11657,36,26238
kroB100.tsp,greedy-ls,greedy-cycle,N1,56,10904,15349,315,26253
kroA100.tsp,greedy-ls,greedy-cycle,N2,72,14435,11657,24,26092
kroB100.tsp,steepest-ls,random-walk,N1,92,23262,21715,664,44977
kroA100.tsp,steepest-ls,random-walk,N2,82,14898,12038,343,26936
kroA100.tsp,greedy-ls,random-walk,N1,75,22207,20471,776,42678
kroA100.tsp,greedy-ls,greedy-cycle,N1,19,15198,12386,32,27584
kroB100.tsp,greedy-ls,random-walk,N1,1,23842,15209,991,39051
kroB100.tsp,steepest-ls,random-walk,N2,16,15946,13535,279,29481
kroB100.tsp,greedy-ls,random-walk,N1,54,19612,17722,368,37334
kroB100.tsp,steepest-ls,greedy-cycle,N1,26,10730,14227,73,24957
kroA100.tsp,steepest-ls,random-walk,N1,92,19976,15955,517,35931
kroA100.tsp,greedy-ls,random-walk,N2,65,14263,10811,245,25074
kroA100.tsp,steepest-ls,greedy-cycle,N1,10,14595,11657,41,26252
kroB100.tsp,greedy-ls,random-walk,N2,44,16098,12680,338,28778
kroB100.tsp,steepest-ls,greedy-cycle,N2,36,14882,10859,69,25741
kroA100.tsp,steepest-ls,greedy-cycle,N2,57,11713,14957,65,26670
kroA100.tsp,greedy-ls,random-walk,N1,22,20245,18169,458,38414
kroB100.tsp,steepest-ls,greedy-cycle,N1,71,11205,15678,41,26883
kroB100.tsp,steepest-ls,random-walk,N2,41,12943,12626,416,25569
kroA100.tsp,steepest-ls,greedy-cycle,N1,47,14995,11657,32,26652
kroA100.tsp,greedy-ls,random-walk,N2,32,15920,9801,251,25721
kroB100.tsp,steepest-ls,greedy-cycle,N2,61,10827,15415,82,26242
kroB100.tsp,greedy-ls,greedy-cycle,N1,95,12191,16227,377,28418
kroB100.tsp,greedy-ls,random-walk,N2,13,15923,12832,195,28755
kroB100.tsp,steepest-ls,random-walk,N1,51,22381,16588,583,38969
kroB100.tsp,steepest-ls,greedy-cycle,N1,88,15347,11907,66,27254
kroA100.tsp,greedy-ls,random-walk,N2,6,15224,9772,249,24996
kroA100.tsp,greedy-ls,random-walk,N1,34,18167,17952,210,36119
kroB100.tsp,greedy-ls,greedy-cycle,N2,3,11108,13992,29,25100
kroA100.tsp,greedy-ls,greedy-cycle,N1,58,11480,15146,43,26626
kroA100.tsp,steepest-ls,greedy-cycle,N2,41,12386,15198,53,27584
kroB100.tsp,steepest-ls,random-walk,N2,57,15490,10167,602,25657
kroB100.tsp,greedy-ls,random-walk,N1,15,19217,23035,325,42252
kroB100.tsp,steepest-ls,greedy-cycle,N1,67,10288,16742,43,27030
kroA100.tsp,steepest-ls,greedy-cycle,N1,3,12386,15198,52,27584
kroB100.tsp,steepest-ls,greedy-cycle,N2,98,11194,14354,144,25548
kroA100.tsp,greedy-ls,random-walk,N2,24,15428,10556,208,25984
kroA100.tsp,steepest-ls,greedy-cycle,N1,51,11698,15934,47,27632
kroA100.tsp,greedy-ls,greedy-cycle,N2,48,12386,15198,59,27584
kroB100.tsp,steepest-ls,random-walk,N1,47,21505,19198,538,40703
kroB100.tsp,greedy-ls,greedy-cycle,N1,83,14204,10985,429,25189
kroB100.tsp,steepest-ls,greedy-cycle,N2,77,14384,11305,119,25689
kroA100.tsp,steepest-ls,greedy-cycle,N2,16,15486,12386,89,27872
kroA100.tsp,greedy-ls,random-walk,N1,63,18073,18722,304,36795
kroA100.tsp,steepest-ls,random-walk,N2,94,14982,11231,354,26213
kroB100.tsp,steepest-ls,greedy-cycle,N1,30,11027,15534,301,26561
kroB100.tsp,greedy-ls,random-walk,N1,42,22248,17810,242,40058
kroB100.tsp,steepest-ls,greedy-cycle,N2,6,14317,10353,66,24670
kroA100.tsp,greedy-ls,random-walk,N2,73,16886,10027,210,26913
kroA100.tsp,steepest-ls,random-walk,N1,84,19365,17865,544,37230
kroB100.tsp,steepest-ls,greedy-cycle,N2,20,10838,15443,56,26281
kroB100.tsp,greedy-ls,random-walk,N2,52,14411,12640,187,27051
kroB100.tsp,steepest-ls,random-walk,N1,10,23866,17487,487,41353
kroB100.tsp,greedy-ls,random-walk,N2,25,15307,12771,364,28078
kroB100.tsp,steepest-ls,random-walk,N1,67,25548,19710,406,45258
kroA100.tsp,greedy-ls,greedy-cycle,N2,87,11830,15358,28,27188
kroB100.tsp,steepest-ls,greedy-cycle,N2,57,10827,15415,207,26242
kroA100.tsp,steepest-ls,greedy-cycle,N1,71,12386,15198,52,27584
kroA100.tsp,greedy-ls,greedy-cycle,N2,68,11502,14571,40,26073
kroB100.tsp,steepest-ls,random-walk,N1,88,23745,17936,399,41681
kroB100.tsp,greedy-ls,greedy-cycle,N2,85,11108,14083,31,25191
kroB100.tsp,steepest-ls,random-walk,N2,77,15621,12105,382,27726
kroB100.tsp,greedy-ls,random-walk,N1,35,21511,19623,518,41134
kroA100.tsp,greedy-ls,greedy-cycle,N2,2,11502,14991,25,26493
kroA100.tsp,greedy-ls,greedy-cycle,N1,97,15198,12386,22,27584
kroB100.tsp,steepest-ls,greedy-cycle,N1,47,11219,16084,187,27303
kroA100.tsp,greedy-ls,random-walk,N1,14,22507,15133,277,37640
kroA100.tsp,greedy-ls,greedy-cycle,N1,78,11502,15437,25,26939
kroA100.tsp,steepest-ls,greedy-cycle,N2,61,11698,14957,52,26655
kroB100.tsp,greedy-ls,greedy-cycle,N1,95,12238,16228,28,28466
kroB100.tsp,steepest-ls,random-walk,N2,98,16286,13800,379,30086
kroB100.tsp,greedy-ls,random-walk,N2,72,15835,14742,181,30577
kroB100.tsp,steepest-ls,random-walk,N1,30,19555,15696,1402,35251
kroA100.tsp,steepest-ls,greedy-cycle,N1,26,15198,12386,61,27584
kroA100.tsp,greedy-ls,random-walk,N2,53,14285,12638,961,26923
kroB100.tsp,steepest-ls,greedy-cycle,N1,10,11909,16449,70,28358
kroB100.tsp,steepest-ls,random-walk,N2,20,14609,12557,365,27166
kroB100.tsp,greedy-ls,random-walk,N1,62,18576,21524,233,40100
kroA100.tsp,steepest-ls,greedy-cycle,N2,36,14435,11657,39,26092
kroA100.tsp,greedy-ls,random-walk,N1,43,25467,19485,208,44952
kroB100.tsp,greedy-ls,random-walk,N2,64,16422,9035,842,25457
kroB100.tsp,steepest-ls,random-walk,N1,26,17646,19665,657,37311
kroA100.tsp,steepest-ls,random-walk,N2,4,13057,12569,313,25626
kroB100.tsp,steepest-ls,greedy-cycle,N2,16,14384,11305,49,25689
kroB100.tsp,steepest-ls,random-walk,N2,6,15641,12789,1063,28430
kroA100.tsp,greedy-ls,random-walk,N2,45,14169,14752,341,28921
kroB100.tsp,greedy-ls,greedy-cycle,N1,5,10575,16629,114,27204
kroB100.tsp,greedy-ls,random-walk,N2,8,15944,14461,192,30405
kroA100.tsp,greedy-ls,greedy-cycle,N2,29,12386,15198,34,27584
kroA100.tsp,steepest-ls,greedy-cycle,N1,30,12333,15083,68,27416
kroB100.tsp,steepest-ls,random-walk,N2,36,17070,12734,884,29804
kroB100.tsp,greedy-ls,random-walk,N1,74,19050,16131,275,35181
kroA100.tsp,greedy-ls,random-walk,N1,55,25502,18231,273,43733
kroA100.tsp,steepest-ls,greedy-cycle,N2,20,11713,14957,97,26670
kroA100.tsp,greedy-ls,greedy-cycle,N1,39,12333,15083,30,27416
kroB100.tsp,steepest-ls,greedy-cycle,N2,41,14882,10859,72,25741
kroA100.tsp,steepest-ls,greedy-cycle,N1,88,15486,12386,59,27872
kroA100.tsp,greedy-ls,greedy-cycle,N2,91,14164,11657,17,25821
kroB100.tsp,greedy-ls,random-walk,N2,33,18389,12198,206,30587
kroB100.tsp,steepest-ls,random-walk,N1,71,27261,19085,397,46346
kroB100.tsp,greedy-ls,greedy-cycle,N2,93,11108,13992,38,25100
kroA100.tsp,steepest-ls,greedy-cycle,N1,67,13148,12828,50,25976
kroA100.tsp,greedy-ls,random-walk,N2,12,15101,11424,258,26525
kroB100.tsp,steepest-ls,greedy-cycle,N1,51,14408,10763,71,25171
kroA100.tsp,greedy-ls,greedy-cycle,N1,81,11551,14139,42,25690
kroA100.tsp,steepest-ls,greedy-cycle,N2,98,14428,11657,53,26085
kroB100.tsp,steepest-ls,random-walk,N2,61,16549,11500,357,28049
kroB100.tsp,greedy-ls,random-walk,N1,23,26194,20729,257,46923
kroB100.tsp,greedy-ls,greedy-cycle,N1,83,13672,10312,37,23984
kroA100.tsp,steepest-ls,greedy-cycle,N2,77,11876,15476,50,27352
kroB100.tsp,greedy-ls,random-walk,N1,100,21280,20778,199,42058
kroB100.tsp,greedy-ls,greedy-cycle,N1,21,12238,16228,336,28466
kroA100.tsp,greedy-ls,random-walk,N2,69,14271,10945,195,25216
kroA100.tsp,steepest-ls,random-walk,N1,71,23341,16080,457,39421
kroA100.tsp,greedy-ls,random-walk,N2,86,13154,12247,591,25401
kroB100.tsp,greedy-ls,random-walk,N2,48,14131,13170,198,27301
kroA100.tsp,steepest-ls,random-walk,N1,1,22162,22761,758,44923
kroA100.tsp,greedy-ls,greedy-cycle,N1,15,14700,11657,28,26357
kroA100.tsp,greedy-ls,random-walk,N1,79,21080,18007,582,39087
kroA100.tsp,steepest-ls,random-walk,N2,61,14707,12105,353,26812
kroA100.tsp,greedy-ls,random-walk,N1,96,21641,19144,292,40785
kroB100.tsp,steepest-ls,random-walk,N1,3,25790,18924,697,44714
kroB100.tsp,greedy-ls,random-walk,N1,58,25981,20577,219,46558
kroB100.tsp,greedy-ls,greedy-cycle,N1,17,16619,10859,18,27478
kroB100.tsp,steepest-ls,greedy-cycle,N2,82,14017,10353,240,24370
kroB100.tsp,greedy-ls,greedy-cycle,N1,76,11194,15678,1083,26872
kroA100.tsp,greedy-ls,greedy-cycle,N2,52,11502,14705,53,26207
kroB100.tsp,greedy-ls,greedy-cycle,N2,50,15164,11807,31,26971
kroB100.tsp,greedy-ls,greedy-cycle,N1,99,11205,15678,138,26883
kroA100.tsp,steepest-ls,random-walk,N1,26,24268,14533,545,38801
kroB100.tsp,steepest-ls,greedy-cycle,N1,92,15985,11305,99,27290
kroA100.tsp,greedy-ls,greedy-cycle,N1,42,13485,12074,50,25559
kroB100.tsp,greedy-ls,greedy-cycle,N1,40,10342,16742,36,27084
kroA100.tsp,steepest-ls,random-walk,N2,36,16521,13579,337,30100
kroA100.tsp,greedy-ls,greedy-cycle,N2,44,11502,15216,24,26718
kroB100.tsp,greedy-ls,greedy-cycle,N1,60,12407,14482,1073,26889
kroA100.tsp,greedy-ls,greedy-cycle,N1,7,11669,16156,25,27825
kroA100.tsp,greedy-ls,random-walk,N2,28,16268,11409,257,27677
kroB100.tsp,steepest-ls,greedy-cycle,N2,94,10827,15415,66,26242
kroA100.tsp,steepest-ls,random-walk,N1,30,20832,18666,681,39498
kroB100.tsp,greedy-ls,greedy-cycle,N2,46,10827,15536,32,26363
kroA100.tsp,greedy-ls,greedy-cycle,N1,54,11600,14330,102,25930
kroA100.tsp,greedy-ls,random-walk,N1,38,19646,19437,275,39083
kroB100.tsp,steepest-ls,greedy-cycle,N1,84,10826,16765,30,27591
kroA100.tsp,steepest-ls,random-walk,N2,20,14245,12286,351,26531
kroB100.tsp,greedy-ls,random-walk,N1,19,24057,19538,367,43595
kroB100.tsp,greedy-ls,greedy-cycle,N1,56,10708,13854,64,24562
kroA100.tsp,steepest-ls,random-walk,N1,88,23777,20976,502,44753
kroB100.tsp,greedy-ls,greedy-cycle,N1,37,11256,17026,746,28282
kroA100.tsp,greedy-ls,greedy-cycle,N2,13,11657,14435,24,26092
kroB100.tsp,greedy-ls,greedy-cycle,N2,11,11108,13946,30,25054
kroA100.tsp,greedy-ls,random-walk,N2,90,16642,13958,195,30600
kroA100.tsp,steepest-ls,random-walk,N1,67,23303,20068,392,43371
kroA100.tsp,steepest-ls,random-walk,N2,98,15363,13938,292,29301
kroA100.tsp,greedy-ls,random-walk,N1,80,20203,19251,482,39454
kroA100.tsp,steepest-ls,random-walk,N2,77,14966,12778,346,27744
kroA100.tsp,steepest-ls,random-walk,N2,99,15055,9204,348,24259
kroA100.tsp,greedy-ls,random-walk,N1,81,20212,19554,377,39766
kroA100.tsp,steepest-ls,random-walk,N2,76,14257,12560,359,26817
kroA100.tsp,steepest-ls,random-walk,N1,89,22812,21414,495,44226
kroB100.tsp,greedy-ls,greedy-cycle,N1,36,16703,10859,243,27562
kroA100.tsp,greedy-ls,greedy-cycle,N2,12,12439,14916,21,27355
kroB100.tsp,greedy-ls,greedy-cycle,N2,10,10896,15907,27,26803
kroA100.tsp,greedy-ls,random-walk,N2,91,14790,13434,228,28224
kroA100.tsp,steepest-ls,random-walk,N1,66,22065,18328,451,40393
kroA100.tsp,greedy-ls,greedy-cycle,N1,55,11669,16156,32,27825
kroA100.tsp,greedy-ls,random-walk,N1,39,20699,18995,232,39694
kroB100.tsp,steepest-ls,greedy-cycle,N1,85,11119,15138,42,26257
kroA100.tsp,steepest-ls,random-walk,N2,21,15361,12907,383,28268
kroB100.tsp,greedy-ls,random-walk,N1,18,19540,21395,195,40935
kroB100.tsp,greedy-ls,greedy-cycle,N1,57,10827,16739,11,27566
kroA100.tsp,greedy-ls,greedy-cycle,N2,45,14164,11657,31,25821
kroB100.tsp,greedy-ls,greedy-cycle,N1,61,10827,16739,581,27566
kroA100.tsp,greedy-ls,greedy-cycle,N1,6,15513,12386,16,27899
kroA100.tsp,greedy-ls,random-walk,N2,29,13426,12586,203,26012
kroB100.tsp,steepest-ls,greedy-cycle,N2,95,11506,14572,86,26078
kroA100.tsp,steepest-ls,random-walk,N1,31,26618,19414,610,46032
kroB100.tsp,greedy-ls,greedy-cycle,N2,47,10708,16278,32,26986
kroB100.tsp,steepest-ls,greedy-cycle,N1,93,11119,15138,44,26257
kroA100.tsp,greedy-ls,greedy-cycle,N1,43,12386,15198,38,27584
kroB100.tsp,greedy-ls,greedy-cycle,N1,41,16703,10859,29,27562
kroA100.tsp,steepest-ls,random-walk,N2,37,15942,14126,304,30068
kroB100.tsp,steepest-ls,greedy-cycle,N2,83,14317,10353,95,24670
kroB100.tsp,greedy-ls,greedy-cycle,N1,77,14993,11305,839,26298
kroA100.tsp,greedy-ls,greedy-cycle,N2,53,15489,12487,37,27976
kroB100.tsp,greedy-ls,greedy-cycle,N2,51,12979,9318,55,22297
kroB100.tsp,greedy-ls,greedy-cycle,N1,98,11220,15678,192,26898
kroA100.tsp,steepest-ls,random-walk,N1,27,22232,26799,447,49031
kroB100.tsp,greedy-ls,greedy-cycle,N1,100,11010,15938,24,26948
kroA100.tsp,greedy-ls,greedy-cycle,N1,14,12386,15198,25,27584
kroA100.tsp,greedy-ls,random-walk,N1,78,22038,22161,394,44199
kroA100.tsp,steepest-ls,random-walk,N2,60,16643,10578,286,27221
kroA100.tsp,greedy-ls,random-walk,N1,97,25635,16653,569,42288
kroB100.tsp,steepest-ls,random-walk,N1,2,23969,21236,517,45205
kroB100.tsp,greedy-ls,random-walk,N1,59,19534,15140,249,34674
kroB100.tsp,greedy-ls,greedy-cycle,N1,16,14238,11305,72,25543
kroB100.tsp,greedy-ls,greedy-cycle,N1,20,11040,15418,794,26458
kroA100.tsp,greedy-ls,random-walk,N2,68,14830,9709,217,24539
kroA100.tsp,steepest-ls,random-walk,N1,70,20936,17490,502,38426
kroA100.tsp,greedy-ls,random-walk,N2,87,16927,13485,554,30412
kroB100.tsp,greedy-ls,random-walk,N2,49,16381,13116,231,29497
kroB100.tsp,steepest-ls,greedy-cycle,N1,50,15384,11807,61,27191
kroA100.tsp,steepest-ls,greedy-cycle,N2,99,14435,11657,54,26092
kroA100.tsp,greedy-ls,greedy-cycle,N1,80,13485,12074,28,25559
kroB100.tsp,steepest-ls,random-walk,N2,60,15132,13025,351,28157
kroB100.tsp,greedy-ls,random-walk,N1,22,18251,20092,212,38343
kroB100.tsp,greedy-ls,greedy-cycle,N1,82,14899,10763,30,25662
kroA100.tsp,steepest-ls,greedy-cycle,N2,76,11657,14435,59,26092
kroA100.tsp,greedy-ls,greedy-cycle,N1,100,12386,15198,26,27584
kroB100.tsp,steepest-ls,greedy-cycle,N2,40,10153,16651,24,26804
kroA100.tsp,greedy-ls,greedy-cycle,N2,90,15513,12386,18,27899
kroA100.tsp,steepest-ls,greedy-cycle,N1,89,11860,11668,108,23528
kroB100.tsp,greedy-ls,random-walk,N2,32,15482,10579,250,26061
kroB100.tsp,steepest-ls,random-walk,N1,70,26039,18836,607,44875
kroB100.tsp,greedy-ls,greedy-cycle,N2,92,14631,11867,55,26498
kroA100.tsp,steepest-ls,greedy-cycle,N1,66,15198,12386,55,27584
kroA100.tsp,greedy-ls,random-walk,N2,13,13109,13450,301,26559
kroB100.tsp,steepest-ls,random-walk,N2,37,14893,13434,452,28327
kroB100.tsp,greedy-ls,random-walk,N1,75,20077,20023,245,40100
kroA100.tsp,greedy-ls,random-walk,N1,54,21598,17197,329,38795
kroA100.tsp,greedy-ls,greedy-cycle,N1,38,14581,11657,16,26238
kroA100.tsp,steepest-ls,greedy-cycle,N2,21,14435,11657,49,26092
kroB100.tsp,greedy-ls,random-walk,N2,65,16681,10155,375,26836
kroB100.tsp,steepest-ls,random-walk,N1,27,22404,18351,417,40755
kroA100.tsp,steepest-ls,random-walk,N2,5,15799,12388,353,28187
kroB100.tsp,steepest-ls,greedy-cycle,N2,17,14882,10859,124,25741
kroB100.tsp,steepest-ls,random-walk,N2,7,13494,14464,599,27958
kroA100.tsp,greedy-ls,random-walk,N2,44,16413,10448,473,26861
kroB100.tsp,greedy-ls,greedy-cycle,N1,4,13785,10680,136,24465
kroB100.tsp,greedy-ls,random-walk,N2,9,16061,11247,209,27308
kroA100.tsp,steepest-ls,greedy-cycle,N1,31,11860,11668,277,23528
kroA100.tsp,greedy-ls,greedy-cycle,N2,28,13148,12325,29,25473
kroB100.tsp,steepest-ls,greedy-cycle,N1,11,11119,15138,44,26257
kroB100.tsp,steepest-ls,random-walk,N2,21,16101,13923,273,30024
kroB100.tsp,greedy-ls,random-walk,N1,63,19293,22757,217,42050
kroA100.tsp,steepest-ls,greedy-cycle,N2,37,11502,14424,69,25926
kroA100.tsp,greedy-ls,random-walk,N1,42,26319,20783,195,47102
kroB100.tsp,greedy-ls,random-walk,N2,73,17698,10557,221,28255
kroB100.tsp,steepest-ls,random-walk,N1,31,20756,17795,521,38551
kroA100.tsp,steepest-ls,greedy-cycle,N1,27,11713,15934,69,27647
kroA100.tsp,greedy-ls,random-walk,N2,52,13621,11683,677,25304
kroA100.tsp,greedy-ls,greedy-cycle,N2,3,12386,15198,19,27584
kroB100.tsp,steepest-ls,random-walk,N2,76,14520,12243,383,26763
kroB100.tsp,greedy-ls,random-walk,N1,34,25555,13513,927,39068
kroA100.tsp,greedy-ls,greedy-cycle,N1,96,11600,14287,37,25887
kroB100.tsp,steepest-ls,greedy-cycle,N1,46,10827,16739,36,27566
kroA100.tsp,greedy-ls,random-walk,N1,15,23720,20868,349,44588
kroA100.tsp,steepest-ls,greedy-cycle,N2,60,11876,15476,70,27352
kroA100.tsp,greedy-ls,greedy-cycle,N1,79,15489,12386,28,27875
kroB100.tsp,greedy-ls,greedy-cycle,N1,94,10827,16739,15,27566
kroB100.tsp,steepest-ls,random-walk,N2,99,14709,13472,316,28181
kroB100.tsp,greedy-ls,random-walk,N2,24,13041,12802,284,25843
kroB100.tsp,steepest-ls,random-walk,N1,66,23327,18692,474,42019
kroA100.tsp,greedy-ls,greedy-cycle,N2,86,11509,14263,43,25772
kroB100.tsp,steepest-ls,greedy-cycle,N2,56,10344,13876,218,24220
kroA100.tsp,greedy-ls,greedy-cycle,N2,69,11502,14991,55,26493
kroA100.tsp,steepest-ls,greedy-cycle,N1,70,15486,12386,49,27872
kroB100.tsp,steepest-ls,random-walk,N1,89,15809,20041,539,35850
kroB100.tsp,greedy-ls,greedy-cycle,N2,84,10837,15555,105,26392
kroA100.tsp,greedy-ls,random-walk,N2,72,14180,11045,210,25225
kroB100.tsp,steepest-ls,greedy-cycle,N2,7,10837,15384,66,26221
kroA100.tsp,steepest-ls,random-walk,N1,85,20328,18434,440,38762
kroB100.tsp,steepest-ls,greedy-cycle,N2,21,11506,14572,57,26078
kroB100.tsp,greedy-ls,random-walk,N2,53,16858,11844,204,28702
kroB100.tsp,steepest-ls,random-walk,N1,11,27521,19417,337,46938
kroA100.tsp,steepest-ls,greedy-cycle,N2,17,14428,11657,102,26085
kroA100.tsp,greedy-ls,random-walk,N1,62,20030,18474,298,38504
kroA100.tsp,steepest-ls,random-walk,N2,95,15615,11457,491,27072
kroB100.tsp,steepest-ls,greedy-cycle,N1,31,14408,10577,96,24985
kroB100.tsp,greedy-ls,random-walk,N1,43,17269,20776,287,38045
kroB100.tsp,steepest-ls,greedy-cycle,N2,99,11194,14354,80,25548
kroA100.tsp,greedy-ls,random-walk,N2,25,14414,11591,243,26005
kroA100.tsp,greedy-ls,greedy-cycle,N2,49,15513,12386,61,27899
kroA100.tsp,steepest-ls,greedy-cycle,N1,50,11600,14330,68,25930
kroB100.tsp,steepest-ls,random-walk,N1,46,24508,18646,1274,43154
kroB100.tsp,greedy-ls,greedy-cycle,N1,82,14899,10763,392,25662
kroB100.tsp,steepest-ls,greedy-cycle,N2,76,11194,14354,124,25548
kroA100.tsp,greedy-ls,random-walk,N2,7,13976,12406,231,26382
kroB100.tsp,steepest-ls,greedy-cycle,N1,89,12450,13865,129,26315
kroB100.tsp,greedy-ls,greedy-cycle,N2,2,14317,10353,26,24670
kroA100.tsp,greedy-ls,random-walk,N1,35,20447,18328,288,38775
kroA100.tsp,steepest-ls,greedy-cycle,N2,40,11502,14991,65,26493
kroA100.tsp,greedy-ls,greedy-cycle,N1,59,14595,11657,30,26252
kroB100.tsp,steepest-ls,random-walk,N2,56,14477,13281,314,27758
kroB100.tsp,greedy-ls,random-walk,N1,14,18115,21962,277,40077
kroB100.tsp,steepest-ls,greedy-cycle,N1,66,12376,13854,199,26230
kroA100.tsp,steepest-ls,greedy-cycle,N1,2,11600,14330,90,25930
kroA100.tsp,steepest-ls,greedy-cycle,N1,46,12386,15198,49,27584
kroA100.tsp,greedy-ls,random-walk,N2,33,15553,10829,308,26382
kroB100.tsp,steepest-ls,greedy-cycle,N2,60,12450,13601,125,26051
kroB100.tsp,greedy-ls,greedy-cycle,N1,94,10827,16739,139,27566
kroB100.tsp,greedy-ls,random-walk,N2,12,16202,14036,196,30238
kroB100.tsp,steepest-ls,random-walk,N1,50,23410,20170,353,43580
kroA100.tsp,steepest-ls,greedy-cycle,N2,56,15198,12386,44,27584
kroA100.tsp,greedy-ls,random-walk,N1,23,26018,17696,1508,43714
kroB100.tsp,steepest-ls,greedy-cycle,N1,70,10342,16742,62,27084
kroB100.tsp,steepest-ls,random-walk,N2,40,15529,13579,528,29108
kroA100.tsp,steepest-ls,random-walk,N1,93,20898,19833,387,40731
kroA100.tsp,greedy-ls,random-walk,N2,64,17016,14651,363,31667
kroA100.tsp,steepest-ls,greedy-cycle,N1,11,14770,11657,40,26427
kroB100.tsp,greedy-ls,random-walk,N2,45,15584,13364,458,28948
kroB100.tsp,steepest-ls,greedy-cycle,N2,37,10628,17104,42,27732
kroA100.tsp,steepest-ls,random-walk,N2,83,13943,12458,325,26401
kroA100.tsp,greedy-ls,random-walk,N1,74,22409,15115,574,37524
kroA100.tsp,greedy-ls,greedy-cycle,N1,18,14595,11657,31,26252
kroB100.tsp,steepest-ls,random-walk,N2,17,14257,13810,944,28067
kroB100.tsp,greedy-ls,random-walk,N1,55,18404,20270,514,38674
kroB100.tsp,steepest-ls,greedy-cycle,N1,27,10827,16739,24,27566
kroB100.tsp,greedy-ls,greedy-cycle,N2,71,11194,14653,48,25847
kroA100.tsp,steepest-ls,greedy-cycle,N1,85,11502,15434,46,26936
kroB100.tsp,greedy-ls,greedy-cycle,N1,57,10827,16739,129,27566
kroA100.tsp,greedy-ls,greedy-cycle,N2,73,11600,14076,96,25676
kroB100.tsp,steepest-ls,random-walk,N1,93,26046,16371,554,42417
kroB100.tsp,greedy-ls,greedy-cycle,N1,61,10827,16739,13,27566
kroA100.tsp,steepest-ls,greedy-cycle,N2,95,11657,14435,37,26092
kroA100.tsp,steepest-ls,random-walk,N2,17,14956,10123,410,25079
kroA100.tsp,greedy-ls,greedy-cycle,N1,63,14698,11657,16,26355
kroB100.tsp,steepest-ls,random-walk,N2,83,15649,12761,407,28410
kroA100.tsp,steepest-ls,random-walk,N1,50,23048,22756,393,45804
kroA100.tsp,steepest-ls,random-walk,N2,9,15349,11405,282,26754
kroB100.tsp,greedy-ls,greedy-cycle,N2,26,10344,13763,46,24107
kroB100.tsp,greedy-ls,random-walk,N2,69,14330,10265,1248,24595
kroB100.tsp,greedy-ls,random-walk,N2,86,15841,13640,257,29481
kroA100.tsp,greedy-ls,greedy-cycle,N2,24,14147,11657,26,25804
kroB100.tsp,greedy-ls,greedy-cycle,N1,8,11194,15678,370,26872
kroB100.tsp,greedy-ls,random-walk,N2,5,16283,11369,195,27652
kroA100.tsp,greedy-ls,random-walk,N2,48,16889,11452,734,28341
kroA100.tsp,steepest-ls,random-walk,N2,40,15123,10824,322,25947
kroB100.tsp,greedy-ls,random-walk,N1,79,18464,17782,266,36246
kroB100.tsp,greedy-ls,greedy-cycle,N1,36,16692,10859,20,27551
kroB100.tsp,greedy-ls,random-walk,N1,96,22425,18371,225,40796
kroA100.tsp,greedy-ls,greedy-cycle,N1,34,11669,16156,29,27825
kroA100.tsp,greedy-ls,random-walk,N1,58,21816,23110,366,44926
kroB100.tsp,greedy-ls,greedy-cycle,N2,30,11061,15324,31,26385
kroA100.tsp,steepest-ls,random-walk,N1,46,18810,18154,789,36964
kroB100.tsp,greedy-ls,greedy-cycle,N1,16,14591,11305,163,25896
kroA100.tsp,greedy-ls,greedy-cycle,N2,32,14157,11657,22,25814
kroB100.tsp,greedy-ls,random-walk,N2,90,14205,11770,197,25975
kroB100.tsp,steepest-ls,greedy-cycle,N1,2,15054,10577,150,25631
kroB100.tsp,greedy-ls,greedy-cycle,N1,20,11027,15534,43,26561
kroA100.tsp,steepest-ls,random-walk,N2,56,13809,12661,349,26470
kroA100.tsp,greedy-ls,greedy-cycle,N1,22,15489,12386,31,27875
kroB100.tsp,greedy-ls,random-walk,N1,80,20346,19297,241,39643
kroA100.tsp,steepest-ls,random-walk,N1,11,25678,21977,506,47655
kroA100.tsp,steepest-ls,greedy-cycle,N1,93,12027,13870,25,25897
kroA100.tsp,greedy-ls,random-walk,N1,2,18695,18893,847,37588
kroB100.tsp,greedy-ls,greedy-cycle,N2,67,10099,16651,21,26750
kroB100.tsp,greedy-ls,greedy-cycle,N1,7,10837,16765,21,27602
kroB100.tsp,greedy-ls,random-walk,N2,28,16148,14166,246,30314
kroB100.tsp,greedy-ls,greedy-cycle,N2,88,14826,11907,85,26733
kroB100.tsp,steepest-ls,random-walk,N1,85,22597,16519,534,39116
kroA100.tsp,greedy-ls,greedy-cycle,N2,65,15198,12386,22,27584
kroA100.tsp,steepest-ls,greedy-cycle,N2,7,11713,14957,68,26670
kroB100.tsp,greedy-ls,greedy-cycle,N1,41,16479,10859,247,27338
kroA100.tsp,steepest-ls,greedy-cycle,N2,83,11713,14957,730,26670
kroB100.tsp,greedy-ls,random-walk,N1,38,24519,24267,399,48786
kroB100.tsp,greedy-ls,greedy-cycle,N1,77,15739,11305,32,27044
kroB100.tsp,steepest-ls,random-walk,N2,95,14720,13983,390,28703
kroB100.tsp,greedy-ls,greedy-cycle,N1,98,11194,15678,19,26872
kroA100.tsp,greedy-ls,greedy-cycle,N1,75,15198,12386,18,27584
kroA100.tsp,greedy-ls,random-walk,N1,19,20408,19990,358,40398
kroB100.tsp,steepest-ls,greedy-cycle,N2,51,14317,10353,91,24670
kroB100.tsp,greedy-ls,random-walk,N2,23,16634,13232,198,29866
kroB100.tsp,steepest-ls,random-walk,N1,61,27857,16459,946,44316
kroA100.tsp,greedy-ls,greedy-cycle,N2,81,11698,15248,51,26946
kroA100.tsp,steepest-ls,greedy-cycle,N1,98,14763,11657,44,26420
kroA100.tsp,greedy-ls,random-walk,N1,9,21664,19231,301,40895
kroA100.tsp,steepest-ls,greedy-cycle,N1,77,11915,15550,49,27465
kroB100.tsp,greedy-ls,greedy-cycle,N2,83,14317,10209,29,24526
kroB100.tsp,steepest-ls,greedy-cycle,N1,41,16692,10859,162,27551
kroB100.tsp,steepest-ls,random-walk,N2,71,15685,11578,455,27263
kroB100.tsp,greedy-ls,random-walk,N1,33,24708,16069,685,40777
kroA100.tsp,greedy-ls,greedy-cycle,N2,4,15198,12386,21,27584
kroA100.tsp,steepest-ls,greedy-cycle,N2,88,15486,12386,193,27872
kroA100.tsp,greedy-ls,greedy-cycle,N1,91,14575,11657,22,26232
kroA100.tsp,steepest-ls,greedy-cycle,N2,67,13353,12498,82,25851
kroB100.tsp,greedy-ls,greedy-cycle,N1,93,11119,15138,29,26257
kroA100.tsp,greedy-ls,random-walk,N1,12,19595,21601,528,41196
kroB100.tsp,greedy-ls,random-walk,N2,74,15908,11313,234,27221
kroB100.tsp,steepest-ls,random-walk,N1,36,23578,18694,768,42272
kroA100.tsp,greedy-ls,random-walk,N2,55,15727,11076,505,26803
kroA100.tsp,steepest-ls,greedy-cycle,N1,20,11713,15934,57,27647
kroA100.tsp,greedy-ls,greedy-cycle,N2,39,12333,15110,28,27443
kroB100.tsp,steepest-ls,greedy-cycle,N1,9,10827,16739,22,27566
kroB100.tsp,steepest-ls,random-walk,N2,26,15664,13228,327,28892
kroB100.tsp,greedy-ls,random-walk,N1,64,24496,13668,251,38164
kroB100.tsp,steepest-ls,greedy-cycle,N1,16,15576,11305,52,26881
kroA100.tsp,greedy-ls,random-walk,N1,45,24290,20502,1058,44792
kroA100.tsp,greedy-ls,greedy-cycle,N1,29,12386,15198,30,27584
kroA100.tsp,steepest-ls,greedy-cycle,N2,30,12333,15083,117,27416
kroA100.tsp,steepest-ls,random-walk,N2,2,14208,10713,402,24921
kroB100.tsp,steepest-ls,greedy-cycle,N2,10,10896,15873,72,26769
kroB100.tsp,greedy-ls,random-walk,N2,62,14757,13367,254,28124
kroB100.tsp,steepest-ls,random-walk,N1,20,22764,18710,454,41474
kroA100.tsp,steepest-ls,greedy-cycle,N1,36,14581,11657,36,26238
kroB100.tsp,greedy-ls,greedy-cycle,N1,3,11108,15138,95,26246
kroA100.tsp,greedy-ls,random-walk,N2,43,16473,10196,980,26669
kroB100.tsp,steepest-ls,random-walk,N2,30,13188,11431,484,24619
kroB100.tsp,greedy-ls,random-walk,N1,72,20719,17295,217,38014
kroA100.tsp,steepest-ls,greedy-cycle,N2,26,15198,12386,64,27584
kroA100.tsp,greedy-ls,random-walk,N1,53,23893,20623,249,44516
kroA100.tsp,greedy-ls,greedy-cycle,N2,97,15198,12386,18,27584
kroB100.tsp,greedy-ls,random-walk,N2,35,15401,12169,246,27570
kroB100.tsp,steepest-ls,random-walk,N1,77,24543,21548,445,46091
kroB100.tsp,steepest-ls,greedy-cycle,N2,47,11505,16324,209,27829
kroA100.tsp,greedy-ls,random-walk,N2,14,16176,10534,216,26710
kroB100.tsp,steepest-ls,random-walk,N1,98,23905,18747,604,42652
kroB100.tsp,greedy-ls,greedy-cycle,N2,95,12068,15082,41,27150
kroA100.tsp,greedy-ls,greedy-cycle,N2,78,11696,15929,28,27625
kroA100.tsp,steepest-ls,greedy-cycle,N1,61,11698,15934,44,27632
kroA100.tsp,greedy-ls,greedy-cycle,N1,87,12412,13799,58,26211
kroB100.tsp,steepest-ls,random-walk,N2,67,17451,12102,324,29553
kroB100.tsp,greedy-ls,random-walk,N1,25,20981,17272,244,38253
kroB100.tsp,steepest-ls,greedy-cycle,N1,57,10827,16739,20,27566
kroB100.tsp,greedy-ls,greedy-cycle,N1,85,11119,15138,37,26257
kroB100.tsp,steepest-ls,random-walk,N2,88,14372,12874,524,27246
kroA100.tsp,steepest-ls,greedy-cycle,N2,71,12386,15198,71,27584
kroA100.tsp,greedy-ls,greedy-cycle,N1,68,12220,14218,39,26438
kroB100.tsp,greedy-ls,greedy-cycle,N1,27,10827,16739,141,27566
kroA100.tsp,steepest-ls,random-walk,N1,98,17613,19222,811,36835
kroA100.tsp,steepest-ls,random-walk,N1,77,23549,20816,323,44365
kroA100.tsp,greedy-ls,random-walk,N2,80,15729,10149,1252,25878
kroA100.tsp,steepest-ls,random-walk,N2,88,14539,14870,315,29409
kroA100.tsp,steepest-ls,random-walk,N1,7,23212,19604,1569,42816
kroA100.tsp,greedy-ls,greedy-cycle,N1,13,11657,14581,29,26238
kroB100.tsp,steepest-ls,random-walk,N1,5,22285,20236,754,42521
kroB100.tsp,greedy-ls,greedy-cycle,N1,11,11119,15138,11,26257
kroA100.tsp,steepest-ls,random-walk,N2,67,14112,13596,331,27708
kroA100.tsp,greedy-ls,random-walk,N1,90,21109,24915,238,46024
kroA100.tsp,greedy-ls,greedy-cycle,N2,54,11502,15216,36,26718
kroB100.tsp,steepest-ls,greedy-cycle,N2,84,10837,15384,141,26221
kroB100.tsp,greedy-ls,greedy-cycle,N1,70,10342,16629,194,26971
kroA100.tsp,greedy-ls,random-walk,N2,38,15665,11639,240,27304
kroA100.tsp,steepest-ls,random-walk,N1,20,17812,20989,529,38801
kroB100.tsp,greedy-ls,greedy-cycle,N2,56,10344,14008,107,24352
kroB100.tsp,greedy-ls,random-walk,N2,19,15096,14194,206,29290
kroA100.tsp,greedy-ls,greedy-cycle,N1,44,11502,15415,25,26917
kroB100.tsp,steepest-ls,greedy-cycle,N1,94,10827,16739,25,27566
kroA100.tsp,greedy-ls,random-walk,N1,28,20405,23273,245,43678
kroA100.tsp,steepest-ls,random-walk,N2,30,14273,12410,354,26683
kroB100.tsp,greedy-ls,greedy-cycle,N1,46,10827,16739,8,27566
kroB100.tsp,greedy-ls,greedy-cycle,N1,66,12463,13781,665,26244
kroA100.tsp,greedy-ls,greedy-cycle,N1,1,12532,11708,139,24240
kroB100.tsp,steepest-ls,greedy-cycle,N2,92,14206,11305,150,25511
kroA100.tsp,greedy-ls,greedy-cycle,N2,42,13485,12074,27,25559
kroB100.tsp,greedy-ls,greedy-cycle,N2,40,9963,16538,21,26501
kroA100.tsp,steepest-ls,random-walk,N1,36,24412,23448,770,47860
kroB100.tsp,greedy-ls,greedy-cycle,N1,89,12440,14345,600,26785
kroB100.tsp,greedy-ls,greedy-cycle,N2,9,10827,15593,25,26420
kroB100.tsp,steepest-ls,greedy-cycle,N1,82,14899,10763,79,25662
kroA100.tsp,greedy-ls,greedy-cycle,N1,52,11502,15436,110,26938
kroB100.tsp,greedy-ls,greedy-cycle,N1,50,15368,11585,28,26953
kroA100.tsp,steepest-ls,random-walk,N2,26,13598,12968,362,26566
kroA100.tsp,steepest-ls,greedy-cycle,N1,9,11713,15934,71,27647
kroA100.tsp,greedy-ls,greedy-cycle,N2,15,14164,11657,28,25821
kroB100.tsp,greedy-ls,greedy-cycle,N1,31,13432,10951,390,24383
kroA100.tsp,greedy-ls,random-walk,N2,79,15157,11756,226,26913
kroA100.tsp,greedy-ls,random-walk,N2,96,17268,13186,239,30454
kroA100.tsp,steepest-ls,random-walk,N1,61,28079,20895,382,48974
kroB100.tsp,greedy-ls,greedy-cycle,N2,17,15539,10859,28,26398
kroB100.tsp,greedy-ls,random-walk,N2,58,17291,13496,374,30787
kroA100.tsp,greedy-ls,random-walk,N1,69,25774,17680,214,43454
kroA100.tsp,greedy-ls,random-walk,N1,86,23352,21556,747,44908
kroA100.tsp,steepest-ls,random-walk,N2,71,14837,11303,344,26140
kroB100.tsp,greedy-ls,random-walk,N1,48,20088,18617,245,38705
kroA100.tsp,steepest-ls,greedy-cycle,N2,84,14435,11657,171,26092
kroB100.tsp,greedy-ls,greedy-cycle,N1,70,10629,16629,19,27258
kroA100.tsp,greedy-ls,greedy-cycle,N2,8,14813,12784,15,27597
kroB100.tsp,steepest-ls,random-walk,N2,92,14990,13200,352,28190
kroA100.tsp,greedy-ls,greedy-cycle,N1,72,14581,11657,36,26238
kroA100.tsp,greedy-ls,random-walk,N1,5,24833,19769,508,44602
kroA100.tsp,steepest-ls,greedy-cycle,N1,94,15486,12386,51,27872
kroB100.tsp,greedy-ls,greedy-cycle,N2,60,12359,13601,104,25960
kroA100.tsp,steepest-ls,random-walk,N1,16,19257,17651,412,36908
kroB100.tsp,greedy-ls,greedy-cycle,N1,46,10827,16739,124,27566
kroB100.tsp,steepest-ls,random-walk,N1,82,19090,15629,508,34719
kroA100.tsp,greedy-ls,greedy-cycle,N2,62,11762,15533,51,27295
kroA100.tsp,steepest-ls,random-walk,N2,51,14500,13204,336,27704
kroB100.tsp,greedy-ls,random-walk,N1,68,17781,21584,230,39365
kroB100.tsp,steepest-ls,greedy-cycle,N1,5,10288,16742,75,27030
kroB100.tsp,greedy-ls,greedy-cycle,N1,27,10827,16739,9,27566
kroA100.tsp,greedy-ls,greedy-cycle,N1,25,11551,14049,58,25600
kroB100.tsp,greedy-ls,random-walk,N1,87,22661,16292,222,38953
kroA100.tsp,greedy-ls,random-walk,N1,49,18934,18857,245,37791
kroA100.tsp,steepest-ls,random-walk,N1,41,26632,21496,476,48128
kroB100.tsp,greedy-ls,greedy-cycle,N2,37,11070,17105,25,28175
kroB100.tsp,greedy-ls,random-walk,N2,78,13872,13662,185,27534
kroA100.tsp,greedy-ls,greedy-cycle,N2,35,11429,14017,40,25446
kroB100.tsp,greedy-ls,random-walk,N2,97,16067,13149,676,29216
kroB100.tsp,greedy-ls,greedy-cycle,N1,11,11108,15138,180,26246
kroA100.tsp,greedy-ls,random-walk,N2,59,16381,10858,305,27239
kroB100.tsp,greedy-ls,greedy-cycle,N1,31,14408,10762,31,25170
kroA100.tsp,steepest-ls,random-walk,N2,47,17138,10464,326,27602
kroB100.tsp,greedy-ls,random-walk,N1,91,19431,22237,190,41668
kroA100.tsp,greedy-ls,greedy-cycle,N1,33,11657,14581,18,26238
kroA100.tsp,steepest-ls,greedy-cycle,N1,100,12386,15198,58,27584
kroB100.tsp,greedy-ls,greedy-cycle,N2,21,11658,14759,35,26417
kroA100.tsp,steepest-ls,random-walk,N1,57,22725,20771,392,43496
kroB100.tsp,greedy-ls,random-walk,N2,2,16933,11202,214,28135
kroB100.tsp,greedy-ls,random-walk,N2,81,14830,12052,308,26882
kroA100.tsp,greedy-ls,greedy-cycle,N2,23,14435,11657,23,26092
kroA100.tsp,steepest-ls,random-walk,N2,10,14076,11816,346,25892
kroB100.tsp,greedy-ls,random-walk,N1,29,29230,20337,304,49567
kroB100.tsp,greedy-ls,greedy-cycle,N1,66,12194,14044,33,26238
kroA100.tsp,steepest-ls,greedy-cycle,N2,92,11860,10969,139,22829
kroA100.tsp,greedy-ls,greedy-cycle,N1,64,11625,16077,35,27702
kroB100.tsp,steepest-ls,random-walk,N2,84,15969,10843,664,26812
kroB100.tsp,greedy-ls,greedy-cycle,N1,89,12268,13868,33,26136
kroB100.tsp,greedy-ls,greedy-cycle,N2,76,11194,14445,44,25639
kroB100.tsp,greedy-ls,random-walk,N2,39,16056,13739,280,29795
kroA100.tsp,steepest-ls,greedy-cycle,N1,82,11657,14581,56,26238
kroA100.tsp,greedy-ls,greedy-cycle,N2,74,14178,11657,41,25835
kroB100.tsp,greedy-ls,greedy-cycle,N2,99,11194,14445,42,25639
kroB100.tsp,steepest-ls,random-walk,N1,94,24590,18711,513,43301
kroB100.tsp,greedy-ls,greedy-cycle,N1,50,15304,11807,299,27111
kroA100.tsp,greedy-ls,random-walk,N2,18,15763,13154,255,28917
kroA100.tsp,steepest-ls,random-walk,N2,84,14917,12334,338,27251
kroA100.tsp,greedy-ls,random-walk,N1,73,26431,22647,403,49078
kroB100.tsp,steepest-ls,greedy-cycle,N1,20,11027,15534,74,26561
kroB100.tsp,greedy-ls,random-walk,N1,7,19261,20347,445,39608
kroB100.tsp,steepest-ls,random-walk,N2,10,17424,11324,600,28748
kroB100.tsp,greedy-ls,random-walk,N1,52,17662,17582,312,35244
kroB100.tsp,steepest-ls,random-walk,N1,9,24730,18487,516,43217
kroA100.tsp,steepest-ls,greedy-cycle,N1,16,15486,12386,52,27872
kroA100.tsp,steepest-ls,random-walk,N1,94,25021,24523,478,49544
kroA100.tsp,greedy-ls,random-walk,N2,63,15177,12023,277,27200
kroB100.tsp,steepest-ls,greedy-cycle,N2,30,10838,15443,60,26281
kroB100.tsp,greedy-ls,random-walk,N2,42,15172,14869,176,30041
kroA100.tsp,greedy-ls,random-walk,N1,24,22098,21448,632,43546
kroB100.tsp,steepest-ls,greedy-cycle,N1,98,11205,15678,75,26883
kroA100.tsp,steepest-ls,greedy-cycle,N2,51,11698,14957,55,26655
kroA100.tsp,greedy-ls,greedy-cycle,N1,48,12386,15198,34,27584
kroB100.tsp,steepest-ls,random-walk,N2,47,15867,14079,721,29946
kroB100.tsp,steepest-ls,greedy-cycle,N1,77,15576,11305,96,26881
kroA100.tsp,greedy-ls,random-walk,N2,34,15017,10451,331,25468
kroB100.tsp,steepest-ls,greedy-cycle,N2,88,14968,11907,118,26875
kroA100.tsp,greedy-ls,greedy-cycle,N2,58,11674,15518,36,27192
kroA100.tsp,steepest-ls,greedy-cycle,N1,41,12386,15198,68,27584
kroB100.tsp,greedy-ls,random-walk,N2,15,17434,11026,204,28460
kroB100.tsp,steepest-ls,random-walk,N1,57,22720,14947,477,37667
kroB100.tsp,steepest-ls,greedy-cycle,N2,67,10099,16651,23,26750
kroB100.tsp,greedy-ls,greedy-cycle,N1,93,11119,15138,165,26257
kroA100.tsp,steepest-ls,greedy-cycle,N2,47,14139,11657,69,25796
kroA100.tsp,greedy-ls,random-walk,N1,32,19679,21969,295,41648
kroB100.tsp,greedy-ls,greedy-cycle,N2,5,10099,16651,10,26750
kroA100.tsp,steepest-ls,greedy-cycle,N1,5,11502,15434,61,26936
kroB100.tsp,steepest-ls,greedy-cycle,N1,61,10827,16739,28,27566
kroB100.tsp,steepest-ls,random-walk,N2,51,17652,10861,618,28513
kroB100.tsp,greedy-ls,random-walk,N1,13,23706,16882,337,40588
kroA100.tsp,steepest-ls,greedy-cycle,N1,57,11713,15934,54,27647
kroA100.tsp,greedy-ls,random-walk,N2,22,17440,11705,230,29145
kroB100.tsp,greedy-ls,greedy-cycle,N1,85,11108,15138,216,26246
kroB100.tsp,steepest-ls,greedy-cycle,N2,71,11194,14354,99,25548
kroB100.tsp,steepest-ls,random-walk,N1,41,18907,14292,2089,33199
kroA100.tsp,greedy-ls,random-walk,N1,65,27909,21185,232,49094
kroA100.tsp,steepest-ls,random-walk,N2,92,15368,9704,308,25072
kroA100.tsp,steepest-ls,greedy-cycle,N2,10,14147,11657,52,25804
kroB100.tsp,greedy-ls,random-walk,N1,44,22784,16030,221,38814
kroB100.tsp,steepest-ls,greedy-cycle,N1,36,16692,10859,76,27551
kroA100.tsp,greedy-ls,random-walk,N2,75,15511,12809,252,28320
kroA100.tsp,steepest-ls,random-walk,N1,82,23699,18437,514,42136
kroA100.tsp,greedy-ls,greedy-cycle,N2,19,15198,12386,22,27584
kroB100.tsp,greedy-ls,random-walk,N2,54,17071,11957,247,29028
kroB100.tsp,steepest-ls,random-walk,N1,16,22238,17839,505,40077
kroB100.tsp,steepest-ls,greedy-cycle,N2,26,10344,13876,60,24220
kroA100.tsp,greedy-ls,random-walk,N2,74,17827,12937,283,30764
kroB100.tsp,steepest-ls,greedy-cycle,N2,1,11506,14572,104,26078
kroA100.tsp,steepest-ls,random-walk,N1,83,21009,20476,332,41485
kroA100.tsp,greedy-ls,greedy-cycle,N2,18,13959,11657,28,25616
kroB100.tsp,greedy-ls,random-walk,N2,55,15958,10605,686,26563
kroB100.tsp,steepest-ls,random-walk,N1,17,23360,20949,499,44309
kroB100.tsp,steepest-ls,greedy-cycle,N2,27,10827,15415,45,26242
kroA100.tsp,greedy-ls,random-walk,N1,64,21507,21116,345,42623
kroA100.tsp,steepest-ls,random-walk,N2,93,15498,12190,280,27688
kroA100.tsp,steepest-ls,greedy-cycle,N2,11,14435,11657,75,26092
kroB100.tsp,greedy-ls,random-walk,N1,45,17320,22693,231,40013
kroB100.tsp,steepest-ls,greedy-cycle,N1,37,11316,17195,51,28511
kroA100.tsp,steepest-ls,greedy-cycle,N1,56,15198,12386,47,27584
kroA100.tsp,greedy-ls,random-walk,N2,23,16711,12303,239,29014
kroB100.tsp,greedy-ls,greedy-cycle,N1,84,10826,16765,124,27591
kroB100.tsp,steepest-ls,greedy-cycle,N2,70,10153,16651,32,26804
kroB100.tsp,steepest-ls,random-walk,N1,40,20210,26994,1002,47204
kroA100.tsp,steepest-ls,greedy-cycle,N2,46,12386,15198,106,27584
kroA100.tsp,greedy-ls,random-walk,N2,1,15311,10949,200,26260
kroB100.tsp,greedy-ls,greedy-cycle,N2,4,14204,10648,32,24852
kroA100.tsp,greedy-ls,random-walk,N1,33,21168,18294,789,39462
kroA100.tsp,steepest-ls,greedy-cycle,N1,4,15198,12386,60,27584
kroB100.tsp,steepest-ls,greedy-cycle,N1,60,12450,13865,240,26315
kroB100.tsp,steepest-ls,random-walk,N2,50,14756,12074,380,26830
kroB100.tsp,greedy-ls,random-walk,N1,12,21643,16001,293,37644
kroA100.tsp,greedy-ls,random-walk,N2,35,16197,12439,317,28636
kroB100.tsp,steepest-ls,greedy-cycle,N2,89,12450,13601,291,26051
kroA100.tsp,steepest-ls,greedy-cycle,N1,40,11600,14330,393,25930
kroA100.tsp,greedy-ls,greedy-cycle,N2,59,14196,11657,28,25853
kroB100.tsp,greedy-ls,random-walk,N2,14,17502,12678,190,30180
kroB100.tsp,steepest-ls,random-walk,N1,56,21030,17142,592,38172
kroB100.tsp,steepest-ls,greedy-cycle,N2,66,12405,13081,104,25486
kroB100.tsp,greedy-ls,greedy-cycle,N1,92,15684,11867,168,27551
kroA100.tsp,greedy-ls,random-walk,N1,25,23671,18011,421,41682
kroB100.tsp,steepest-ls,greedy-cycle,N1,99,11205,15678,93,26883
kroA100.tsp,greedy-ls,greedy-cycle,N1,49,15513,12386,67,27899
kroA100.tsp,steepest-ls,greedy-cycle,N2,50,11502,14991,51,26493
kroB100.tsp,steepest-ls,random-walk,N2,46,14406,13047,429,27453
kroB100.tsp,steepest-ls,greedy-cycle,N1,76,11205,15678,86,26883
kroA100.tsp,steepest-ls,greedy-cycle,N1,17,14763,11657,36,26420
kroA100.tsp,steepest-ls,random-walk,N1,95,21910,19162,479,41072
kroA100.tsp,greedy-ls,random-walk,N2,62,14308,12485,298,26793
kroB100.tsp,steepest-ls,greedy-cycle,N2,31,14317,10353,45,24670
kroB100.tsp,greedy-ls,random-walk,N2,43,14109,14412,191,28521
kroA100.tsp,steepest-ls,random-walk,N2,85,16664,12159,309,28823
kroA100.tsp,greedy-ls,random-walk,N1,72,22459,14923,1345,37382
kroB100.tsp,steepest-ls,greedy-cycle,N1,21,12212,15896,64,28108
kroB100.tsp,steepest-ls,random-walk,N2,11,15842,11012,417,26854
kroB100.tsp,greedy-ls,random-walk,N1,53,25633,16552,321,42185
kroB100.tsp,greedy-ls,random-walk,N1,6,21744,20849,363,42593
kroB100.tsp,steepest-ls,random-walk,N1,8,24487,18307,701,42794
kroA100.tsp,steepest-ls,random-walk,N1,100,25641,15066,399,40707
kroB100.tsp,greedy-ls,greedy-cycle,N2,77,14016,11222,51,25238
kroB100.tsp,greedy-ls,random-walk,N2,38,18571,12778,349,31349
kroA100.tsp,steepest-ls,greedy-cycle,N1,83,11713,15934,49,27647
kroA100.tsp,greedy-ls,greedy-cycle,N2,75,15198,12386,24,27584
kroB100.tsp,greedy-ls,greedy-cycle,N2,98,11194,14664,45,25858
kroB100.tsp,steepest-ls,random-walk,N1,95,22573,19495,621,42068
kroB100.tsp,greedy-ls,greedy-cycle,N1,51,14295,10763,286,25058
kroA100.tsp,greedy-ls,random-walk,N2,19,14274,11208,232,25482
kroA100.tsp,steepest-ls,random-walk,N2,11,17769,11411,350,29180
kroB100.tsp,greedy-ls,random-walk,N1,28,23446,15407,549,38853
kroB100.tsp,greedy-ls,greedy-cycle,N1,67,10288,16742,21,27030
kroA100.tsp,steepest-ls,greedy-cycle,N2,93,12016,13870,23,25886
kroA100.tsp,greedy-ls,greedy-cycle,N1,65,15198,12386,26,27584
kroB100.tsp,steepest-ls,random-walk,N2,85,16011,12156,451,28167
kroB100.tsp,greedy-ls,greedy-cycle,N1,88,15301,11907,42,27208
kroA100.tsp,greedy-ls,random-walk,N2,100,15150,11022,234,26172
kroB100.tsp,greedy-ls,greedy-cycle,N2,20,10838,15443,27,26281
kroA100.tsp,steepest-ls,random-walk,N1,56,21245,15454,379,36699
kroB100.tsp,greedy-ls,random-walk,N2,3,15653,14726,197,30379
kroB100.tsp,greedy-ls,random-walk,N2,80,14909,11164,389,26073
kroA100.tsp,greedy-ls,greedy-cycle,N2,22,15489,12386,26,27875
kroB100.tsp,greedy-ls,greedy-cycle,N1,30,11027,15534,46,26561
kroA100.tsp,steepest-ls,random-walk,N2,46,14078,11479,383,25557
kroB100.tsp,greedy-ls,random-walk,N1,90,19703,14310,249,34013
kroA100.tsp,greedy-ls,greedy-cycle,N1,32,14623,11657,20,26280
kroA100.tsp,steepest-ls,random-walk,N1,40,31481,15912,397,47393
kroB100.tsp,greedy-ls,greedy-cycle,N2,36,14973,10859,46,25832
kroB100.tsp,greedy-ls,random-walk,N2,79,13970,12045,263,26015
kroA100.tsp,greedy-ls,greedy-cycle,N2,34,11713,15542,34,27255
kroB100.tsp,greedy-ls,random-walk,N2,96,16613,12908,208,29521
kroB100.tsp,greedy-ls,greedy-cycle,N1,100,10554,14799,394,25353
kroB100.tsp,greedy-ls,greedy-cycle,N1,10,11909,16336,331,28245
kroA100.tsp,greedy-ls,random-walk,N2,58,16928,12328,1606,29256
kroA100.tsp,steepest-ls,random-walk,N2,50,14734,11870,313,26604
kroB100.tsp,greedy-ls,random-walk,N1,69,21139,19069,244,40208
kroB100.tsp,steepest-ls,greedy-cycle,N1,4,14317,10763,115,25080
kroB100.tsp,greedy-ls,greedy-cycle,N1,26,10565,15349,39,25914
kroA100.tsp,greedy-ls,greedy-cycle,N1,24,14595,11657,29,26252
kroB100.tsp,greedy-ls,random-walk,N1,86,23072,19431,217,42503
kroA100.tsp,greedy-ls,random-walk,N1,48,24898,21083,503,45981
kroA100.tsp,greedy-ls,random-walk,N1,4,20091,19085,338,39176
kroA100.tsp,steepest-ls,greedy-cycle,N1,95,11657,14581,43,26238
kroB100.tsp,greedy-ls,greedy-cycle,N1,1,12220,15905,19,28125
kroB100.tsp,greedy-ls,greedy-cycle,N2,61,10827,15415,20,26242
kroA100.tsp,steepest-ls,random-walk,N1,17,22743,15387,384,38130
kroB100.tsp,greedy-ls,greedy-cycle,N1,47,11659,16833,343,28492
kroB100.tsp,steepest-ls,random-walk,N1,83,19637,17507,467,37144
kroA100.tsp,greedy-ls,greedy-cycle,N2,63,14182,11657,27,25839
kroA100.tsp,steepest-ls,greedy-cycle,N2,1,12532,10932,99,23464
kroA100.tsp,steepest-ls,greedy-cycle,N2,85,11502,14424,234,25926
kroB100.tsp,greedy-ls,greedy-cycle,N1,71,11261,15678,23,26939
kroA100.tsp,greedy-ls,greedy-cycle,N2,9,11889,14900,26,26789
kroB100.tsp,steepest-ls,random-walk,N2,93,16712,10624,370,27336
kroA100.tsp,greedy-ls,greedy-cycle,N1,73,11600,14330,62,25930
kroA100.tsp,greedy-ls,random-walk,N1,68,21125,15406,277,36531
kroA100.tsp,greedy-ls,random-walk,N1,87,23967,18798,269,42765
kroA100.tsp,steepest-ls,random-walk,N2,70,14216,10294,343,24510
kroB100.tsp,greedy-ls,random-walk,N1,49,19680,20613,243,40293
kroA100.tsp,greedy-ls,greedy-cycle,N2,14,12386,15198,31,27584
kroB100.tsp,greedy-ls,greedy-cycle,N1,30,11027,15421,1082,26448
kroA100.tsp,greedy-ls,random-walk,N2,78,14721,13768,222,28489
kroA100.tsp,greedy-ls,random-walk,N2,97,14906,11527,233,26433
kroA100.tsp,steepest-ls,random-walk,N1,60,24311,17032,475,41343
kroB100.tsp,greedy-ls,greedy-cycle,N2,16,14659,11305,47,25964
kroB100.tsp,greedy-ls,random-walk,N2,59,13490,14160,235,27650
kroB100.tsp,greedy-ls,greedy-cycle,N2,8,11194,14445,33,25639
kroB100.tsp,steepest-ls,greedy-cycle,N1,83,14317,10763,79,25080
kroB100.tsp,steepest-ls,random-walk,N1,100,21007,22070,759,43077
kroA100.tsp,greedy-ls,greedy-cycle,N1,53,15489,12386,43,27875
kroB100.tsp,greedy-ls,greedy-cycle,N1,51,14295,10577,37,24872
kroA100.tsp,steepest-ls,random-walk,N2,27,16890,11859,394,28749
kroA100.tsp,steepest-ls,greedy-cycle,N1,8,14813,12784,61,27597
kroB100.tsp,greedy-ls,greedy-cycle,N1,67,10288,16742,226,27030
kroB100.tsp,steepest-ls,greedy-cycle,N2,93,11108,13814,94,24922
kroA100.tsp,greedy-ls,greedy-cycle,N2,43,12386,15198,28,27584
kroB100.tsp,greedy-ls,greedy-cycle,N2,41,14887,10859,44,25746
kroA100.tsp,steepest-ls,random-walk,N1,37,19412,19645,459,39057
kroB100.tsp,greedy-ls,greedy-cycle,N1,88,15484,11907,325,27391
kroA100.tsp,greedy-ls,greedy-cycle,N1,45,14770,11657,22,26427
kroB100.tsp,steepest-ls,greedy-cycle,N1,95,12212,15896,95,28108
kroA100.tsp,greedy-ls,random-walk,N1,29,18279,17413,270,35692
kroA100.tsp,steepest-ls,random-walk,N2,31,16449,11092,337,27541
kroB100.tsp,greedy-ls,greedy-cycle,N1,47,11140,16283,45,27423
kroA100.tsp,greedy-ls,greedy-cycle,N2,55,11615,13537,35,25152
kroB100.tsp,steepest-ls,greedy-cycle,N2,85,11108,13814,188,24922
kroB100.tsp,greedy-ls,greedy-cycle,N1,71,11220,15678,341,26898
kroA100.tsp,greedy-ls,random-walk,N2,39,14971,10182,455,25153
kroA100.tsp,steepest-ls,random-walk,N1,21,23665,21779,665,45444
kroB100.tsp,greedy-ls,greedy-cycle,N2,57,10827,15612,64,26439
kroB100.tsp,greedy-ls,random-walk,N2,18,17026,12132,201,29158
kroA100.tsp,steepest-ls,random-walk,N2,89,14642,13012,289,27654
kroA100.tsp,steepest-ls,random-walk,N1,6,24201,15309,742,39510
kroA100.tsp,greedy-ls,greedy-cycle,N1,12,11669,16068,51,27737
kroB100.tsp,steepest-ls,greedy-cycle,N1,100,10730,14227,84,24957
kroB100.tsp,steepest-ls,random-walk,N1,4,21934,19213,819,41147
kroB100.tsp,greedy-ls,greedy-cycle,N1,10,11862,16444,33,28306
kroA100.tsp,steepest-ls,random-walk,N2,66,14775,12687,318,27462
kroA100.tsp,greedy-ls,random-walk,N1,91,21605,16703,648,38308
kroB100.tsp,greedy-ls,greedy-cycle,N1,26,10554,14912,247,25466
kroA100.tsp,steepest-ls,random-walk,N1,99,23423,20625,381,44048
kroA100.tsp,steepest-ls,random-walk,N1,76,21223,15070,506,36293
kroA100.tsp,greedy-ls,random-walk,N2,81,14670,9854,877,24524
kroA100.tsp,greedy-ls,greedy-cycle,N1,86,12300,14035,49,26335
kroB100.tsp,steepest-ls,random-walk,N2,66,14007,13772,318,27779
kroB100.tsp,greedy-ls,random-walk,N1,24,22765,19067,222,41832
kroB100.tsp,steepest-ls,greedy-cycle,N1,56,10730,14227,74,24957
kroB100.tsp,greedy-ls,greedy-cycle,N1,84,10826,16765,12,27591
kroB100.tsp,steepest-ls,random-walk,N2,89,15557,12466,319,28023
kroA100.tsp,greedy-ls,greedy-cycle,N1,69,11600,14330,24,25930
kroA100.tsp,steepest-ls,greedy-cycle,N2,70,15486,12386,101,27872
kroA100.tsp,greedy-ls,greedy-cycle,N2,96,11914,14776,37,26690
kroB100.tsp,greedy-ls,random-walk,N2,34,16263,10905,208,27168
kroB100.tsp,steepest-ls,random-walk,N1,76,21870,18330,510,40200
kroB100.tsp,steepest-ls,greedy-cycle,N2,46,10827,15415,64,26242
kroA100.tsp,greedy-ls,random-walk,N2,15,16535,11996,205,28531
kroB100.tsp,steepest-ls,random-walk,N1,99,20170,19915,653,40085
kroB100.tsp,greedy-ls,greedy-cycle,N2,94,10827,15415,36,26242
kroA100.tsp,steepest-ls,greedy-cycle,N1,60,11915,15550,38,27465
kroA100.tsp,greedy-ls,greedy-cycle,N2,79,15489,12386,35,27875
kroB100.tsp,steepest-ls,random-walk,N2,31,16512,13124,449,29636
kroB100.tsp,greedy-ls,random-walk,N1,73,29511,15347,213,44858
kroA100.tsp,steepest-ls,greedy-cycle,N2,27,11713,14957,137,26670
kroA100.tsp,greedy-ls,random-walk,N1,52,20147,17453,261,37600
kroA100.tsp,steepest-ls,random-walk,N2,3,15589,15187,350,30776
kroB100.tsp,steepest-ls,greedy-cycle,N2,11,11108,13814,94,24922
kroB100.tsp,greedy-ls,random-walk,N2,63,15333,15026,646,30359
kroB100.tsp,steepest-ls,random-walk,N1,21,21148,16658,566,37806
kroA100.tsp,steepest-ls,greedy-cycle,N1,37,11502,15434,59,26936
kroB100.tsp,steepest-ls,random-walk,N2,1,16460,11758,322,28218
kroB100.tsp,greedy-ls,greedy-cycle,N1,2,14941,11392,199,26333
kroA100.tsp,greedy-ls,random-walk,N2,42,15321,11695,1350,27016
kroB100.tsp,steepest-ls,greedy-cycle,N1,8,11205,15678,63,26883
kroB100.tsp,steepest-ls,random-walk,N2,27,14930,12661,537,27591
kroB100.tsp,greedy-ls,random-walk,N1,65,20259,20886,219,41145
kroB100.tsp,steepest-ls,greedy-cycle,N1,17,16692,10859,50,27551
kroA100.tsp,greedy-ls,random-walk,N1,44,20707,17086,292,37793
kroA100.tsp,steepest-ls,greedy-cycle,N2,31,11860,10969,333,22829
kroA100.tsp,greedy-ls,greedy-cycle,N1,28,13148,12731,34,25879
kroB100.tsp,greedy-ls,random-walk,N2,75,16851,12030,303,28881
kroB100.tsp,steepest-ls,random-walk,N1,37,24082,20036,563,44118
kroA100.tsp,greedy-ls,random-walk,N2,54,17501,13521,294,31022
kroA100.tsp,greedy-ls,greedy-cycle,N2,38,14435,11657,22,26092
kroA100.tsp,steepest-ls,greedy-cycle,N1,21,14581,11657,42,26238
kroB100.tsp,steepest-ls,greedy-cycle,N1,40,10342,16742,52,27084
kroA100.tsp,greedy-ls,greedy-cycle,N2,5,11502,14705,25,26207
kroB100.tsp,steepest-ls,random-walk,N2,70,17915,11395,563,29310
kroB100.tsp,greedy-ls,random-walk,N1,32,20285,18658,361,38943
kroA100.tsp,greedy-ls,greedy-cycle,N1,90,15513,12386,17,27899
kroA100.tsp,steepest-ls,greedy-cycle,N2,89,11860,10969,244,22829
kroA100.tsp,steepest-ls,greedy-cycle,N2,66,15198,12386,142,27584
kroB100.tsp,greedy-ls,greedy-cycle,N1,92,15178,11867,34,27045
kroA100.tsp,greedy-ls,random-walk,N1,13,20040,24163,963,44203
kroB100.tsp,steepest-ls,greedy-cycle,N2,50,14988,11807,81,26795
kroB100.tsp,greedy-ls,random-walk,N2,22,14793,11885,176,26678
kroB100.tsp,steepest-ls,random-walk,N1,60,22019,17554,561,39573
kroA100.tsp,steepest-ls,greedy-cycle,N1,99,14581,11657,40,26238
kroA100.tsp,greedy-ls,greedy-cycle,N2,80,13485,12074,36,25559
kroA100.tsp,greedy-ls,random-walk,N1,8,24921,15549,300,40470
kroA100.tsp,steepest-ls,greedy-cycle,N1,76,11657,14581,40,26238
kroB100.tsp,greedy-ls,greedy-cycle,N2,82,14801,10498,43,25299
