instance,solver,start_vertex,cost_first,cost_second,total_cost,duration,max_candidates
kroA200.tsp,candidate-ls,17,19084,18982,38066,1484,15
kroA200.tsp,greedy-cycle,179,21416,18093,39509,2,15
kroB200.tsp,steepest-ls,141,17592,20549,38141,5144,15
kroB200.tsp,qc-ls,73,19212,19112,38324,828,15
kroA200.tsp,steepest-ls,27,19329,19332,38661,4976,15
kroB200.tsp,queue-ls,133,19734,18590,38324,841,15
kroB200.tsp,greedy-cycle,97,20257,18102,38359,3,15
kroA200.tsp,qc-ls,51,19057,17445,36502,843,15
kroA200.tsp,steepest-ls,189,18638,19320,37958,5348,15
kroB200.tsp,greedy-cycle,127,21676,18649,40325,2,15
kroB200.tsp,candidate-ls,107,19892,19278,39170,1519,15
kroB200.tsp,queue-ls,49,20225,18968,39193,900,15
kroA200.tsp,queue-ls,69,18660,19447,38107,884,15
kroA200.tsp,candidate-ls,159,18488,19962,38450,1486,15
kroA200.tsp,steepest-ls,131,17680,18940,36620,5324,15
kroB200.tsp,qc-ls,161,19364,19128,38492,842,15
kroB200.tsp,candidate-ls,67,20355,18972,39327,1431,15
kroA200.tsp,steepest-ls,89,19589,19397,38986,4970,15
kroB200.tsp,candidate-ls,111,19972,20184,40156,1449,15
kroB200.tsp,greedy-cycle,189,18352,21333,39685,2,15
kroA200.tsp,steepest-ls,127,19800,21330,41130,5510,15
kroB200.tsp,greedy-cycle,39,18352,21333,39685,2,15
kroB200.tsp,steepest-ls,7,18281,18515,36796,5220,15
kroB200.tsp,candidate-ls,71,18706,21197,39903,1428,15
kroB200.tsp,qc-ls,177,18587,20489,39076,813,15
kroB200.tsp,queue-ls,125,17937,18987,36924,837,15
kroA200.tsp,greedy-cycle,49,17636,21615,39251,2,15
kroA200.tsp,steepest-ls,31,20218,19548,39766,4988,15
kroB200.tsp,qc-ls,65,21042,19646,40688,837,15
kroB200.tsp,steepest-ls,157,19341,17818,37159,5391,15
kroB200.tsp,greedy-cycle,131,18449,21333,39782,5,15
kroA200.tsp,qc-ls,47,21471,19139,40610,772,15
kroB200.tsp,greedy-cycle,81,20747,18065,38812,2,15
kroA200.tsp,candidate-ls,95,21882,17903,39785,1502,15
kroB200.tsp,queue-ls,73,17947,20683,38630,846,15
kroA200.tsp,queue-ls,53,19286,21110,40396,890,15
kroA200.tsp,candidate-ls,163,21177,19561,40738,1538,15
kroB200.tsp,greedy-cycle,15,17785,17483,35268,2,15
kroA200.tsp,qc-ls,127,20161,19623,39784,766,15
kroB200.tsp,qc-ls,49,18372,20845,39217,836,15
kroA200.tsp,greedy-cycle,65,21564,18253,39817,4,15
kroB200.tsp,queue-ls,109,18774,19593,38367,843,15
kroB200.tsp,candidate-ls,185,19475,19433,38908,1403,15
kroA200.tsp,qc-ls,1,19899,21136,41035,810,15
kroA200.tsp,greedy-cycle,143,17669,22204,39873,4,15
kroA200.tsp,queue-ls,167,19236,19645,38881,851,15
kroB200.tsp,steepest-ls,71,19990,18523,38513,4851,15
kroA200.tsp,greedy-cycle,73,20906,18253,39159,5,15
kroB200.tsp,queue-ls,3,16895,20670,37565,855,15
kroA200.tsp,greedy-cycle,155,20726,17365,38091,5,15
kroB200.tsp,candidate-ls,193,19956,18854,38810,1571,15
kroA200.tsp,qc-ls,189,19660,18433,38093,838,15
kroB200.tsp,steepest-ls,67,18171,18597,36768,5452,15
kroA200.tsp,queue-ls,171,19422,18779,38201,860,15
kroA200.tsp,queue-ls,45,18769,18757,37526,792,15
kroB200.tsp,queue-ls,65,18367,20363,38730,797,15
kroA200.tsp,candidate-ls,83,18899,19219,38118,1536,15
kroA200.tsp,candidate-ls,1,19618,20634,40252,1485,15
kroA200.tsp,qc-ls,131,19701,20062,39763,840,15
kroA200.tsp,candidate-ls,175,18681,20602,39283,1455,15
kroA200.tsp,steepest-ls,185,17615,19262,36877,5023,15
kroB200.tsp,steepest-ls,47,20558,17032,37590,4922,15
kroA200.tsp,queue-ls,151,19143,18812,37955,882,15
kroB200.tsp,greedy-cycle,3,21149,18773,39922,2,15
kroA200.tsp,greedy-cycle,175,17402,18062,35464,2,15
kroA200.tsp,greedy-cycle,53,17458,22307,39765,2,15
kroA200.tsp,qc-ls,111,19740,17472,37212,777,15
kroB200.tsp,greedy-cycle,193,18449,21333,39782,2,15
kroB200.tsp,greedy-cycle,23,17910,20396,38306,2,15
kroA200.tsp,candidate-ls,155,19517,19091,38608,1557,15
kroB200.tsp,queue-ls,187,21434,19551,40985,837,15
kroA200.tsp,steepest-ls,93,19135,19576,38711,5267,15
kroA200.tsp,queue-ls,65,19556,19360,38916,872,15
kroB200.tsp,queue-ls,45,19987,18848,38835,860,15
kroA200.tsp,candidate-ls,143,21116,17977,39093,1522,15
kroB200.tsp,greedy-cycle,35,18884,16849,35733,2,15
kroB200.tsp,greedy-cycle,185,17852,20337,38189,2,15
kroA200.tsp,qc-ls,107,17934,20837,38771,807,15
kroA200.tsp,steepest-ls,85,18302,18477,36779,5176,15
kroB200.tsp,queue-ls,191,18326,19364,37690,888,15
kroB200.tsp,queue-ls,53,19083,19990,39073,823,15
kroA200.tsp,queue-ls,73,20373,19910,40283,837,15
kroA200.tsp,queue-ls,147,17753,19256,37009,866,15
kroB200.tsp,steepest-ls,51,18344,21004,39348,4975,15
kroA200.tsp,steepest-ls,193,19283,20133,39416,4870,15
kroA200.tsp,greedy-cycle,163,17722,22204,39926,2,15
kroB200.tsp,qc-ls,69,19895,18984,38879,799,15
kroA200.tsp,greedy-cycle,45,17924,17472,35396,2,15
kroB200.tsp,queue-ls,129,19242,18934,38176,842,15
kroB200.tsp,candidate-ls,51,20306,18173,38479,1504,15
kroB200.tsp,qc-ls,157,18458,19894,38352,835,15
kroA200.tsp,steepest-ls,107,19968,19038,39006,4879,15
kroB200.tsp,greedy-cycle,19,17024,19852,36876,2,15
kroA200.tsp,candidate-ls,99,20143,19741,39884,1432,15
kroB200.tsp,candidate-ls,131,19820,20085,39905,1592,15
kroB200.tsp,greedy-cycle,111,21676,18649,40325,3,15
kroA200.tsp,qc-ls,193,19679,19812,39491,807,15
kroA200.tsp,qc-ls,67,19608,18641,38249,808,15
kroB200.tsp,queue-ls,105,19565,19366,38931,851,15
kroA200.tsp,greedy-cycle,69,17669,22204,39873,2,15
kroA200.tsp,steepest-ls,11,18997,19124,38121,5201,15
kroB200.tsp,qc-ls,45,19226,19680,38906,829,15
kroB200.tsp,steepest-ls,177,19583,21604,41187,4952,15
kroA200.tsp,candidate-ls,21,20213,19704,39917,1496,15
kroB200.tsp,candidate-ls,189,18827,20164,38991,1500,15
kroA200.tsp,qc-ls,71,18587,18996,37583,867,15
kroA200.tsp,qc-ls,185,19774,20310,40084,873,15
kroB200.tsp,greedy-cycle,107,17075,19852,36927,2,15
kroB200.tsp,steepest-ls,161,20778,20101,40879,5139,15
kroB200.tsp,qc-ls,53,19649,19054,38703,870,15
kroB200.tsp,queue-ls,113,18844,18353,37197,918,15
kroA200.tsp,candidate-ls,37,19873,21514,41387,1479,15
kroA200.tsp,greedy-cycle,159,16626,21633,38259,2,15
kroB200.tsp,qc-ls,141,19254,19804,39058,849,15
kroB200.tsp,candidate-ls,47,19643,19993,39636,1544,15
kroA200.tsp,candidate-ls,179,18288,19934,38222,1492,15
kroA200.tsp,steepest-ls,111,19875,17908,37783,5636,15
kroB200.tsp,candidate-ls,127,18304,19478,37782,1480,15
kroB200.tsp,queue-ls,69,19317,20336,39653,788,15
kroA200.tsp,queue-ls,49,20077,20469,40546,830,15
kroB200.tsp,queue-ls,145,19816,18488,38304,835,15
kroA200.tsp,greedy-cycle,29,17298,22606,39904,2,15
kroA200.tsp,steepest-ls,51,20341,19432,39773,5306,15
kroB200.tsp,steepest-ls,137,19051,19641,38692,4959,15
kroB200.tsp,queue-ls,87,20774,18201,38975,893,15
kroA200.tsp,candidate-ls,61,20177,19275,39452,1540,15
kroB200.tsp,greedy-cycle,151,17075,19852,36927,2,15
kroA200.tsp,qc-ls,27,20585,19968,40553,773,15
kroA200.tsp,candidate-ls,197,18375,21553,39928,1513,15
kroB200.tsp,candidate-ls,171,20285,18621,38906,1458,15
kroA200.tsp,greedy-cycle,91,21703,18093,39796,2,15
kroB200.tsp,candidate-ls,11,21367,18633,40000,1467,15
kroB200.tsp,qc-ls,117,20660,19535,40195,782,15
kroA200.tsp,steepest-ls,147,19547,18978,38525,5005,15
kroB200.tsp,steepest-ls,85,20500,20713,41213,4822,15
kroB200.tsp,greedy-cycle,59,17789,20510,38299,6,15
kroA200.tsp,queue-ls,193,18781,18265,37046,804,15
kroB200.tsp,candidate-ls,167,19815,18331,38146,1476,15
kroB200.tsp,queue-ls,29,21047,19631,40678,867,15
kroB200.tsp,steepest-ls,199,19669,18277,37946,4878,15
kroA200.tsp,greedy-cycle,87,16872,20167,37039,5,15
kroB200.tsp,qc-ls,101,18752,20341,39093,811,15
kroA200.tsp,queue-ls,185,18571,19320,37891,833,15
kroA200.tsp,candidate-ls,139,19328,20567,39895,1422,15
kroA200.tsp,qc-ls,89,19492,18559,38051,855,15
kroB200.tsp,steepest-ls,93,19851,18524,38375,5010,15
kroA200.tsp,steepest-ls,151,19389,19613,39002,5130,15
kroB200.tsp,steepest-ls,121,21108,19296,40404,5124,15
kroB200.tsp,qc-ls,13,18986,19000,37986,808,15
kroA200.tsp,steepest-ls,47,20227,17949,38176,5256,15
kroB200.tsp,queue-ls,153,20452,18663,39115,859,15
kroA200.tsp,candidate-ls,77,19577,20481,40058,1510,15
kroB200.tsp,queue-ls,91,19659,20221,39880,809,15
kroA200.tsp,greedy-cycle,119,16527,21633,38160,2,15
kroA200.tsp,candidate-ls,181,21024,17750,38774,1590,15
kroA200.tsp,qc-ls,31,19949,19025,38974,809,15
kroB200.tsp,greedy-cycle,147,18987,16849,35836,2,15
kroA200.tsp,steepest-ls,3,20777,18862,39639,5184,15
kroA200.tsp,greedy-cycle,3,20757,17365,38122,2,15
kroB200.tsp,qc-ls,87,20345,19242,39587,889,15
kroA200.tsp,queue-ls,25,19911,19946,39857,802,15
kroA200.tsp,qc-ls,151,19750,18972,38722,870,15
kroB200.tsp,greedy-cycle,63,20857,18065,38922,2,15
kroA200.tsp,candidate-ls,115,19909,19607,39516,1497,15
kroB200.tsp,qc-ls,9,19276,16503,35779,794,15
kroA200.tsp,greedy-cycle,135,18273,17472,35745,2,15
kroA200.tsp,greedy-cycle,13,20543,18253,38796,2,15
kroB200.tsp,candidate-ls,93,19567,19332,38899,1445,15
kroB200.tsp,qc-ls,195,19318,19562,38880,841,15
kroA200.tsp,queue-ls,111,20761,17039,37800,807,15
kroA200.tsp,greedy-cycle,123,18388,17472,35860,2,15
kroB200.tsp,qc-ls,29,18586,19594,38180,828,15
kroB200.tsp,queue-ls,169,18244,20306,38550,867,15
kroB200.tsp,qc-ls,183,18140,18606,36746,876,15
kroB200.tsp,candidate-ls,85,19977,19853,39830,1445,15
kroA200.tsp,queue-ls,107,18355,19424,37779,870,15
kroB200.tsp,steepest-ls,11,21033,18594,39627,4835,15
kroB200.tsp,qc-ls,91,17720,20210,37930,763,15
kroB200.tsp,queue-ls,13,19630,19278,38908,788,15
kroA200.tsp,queue-ls,33,18429,20296,38725,806,15
kroA200.tsp,candidate-ls,103,19640,18306,37946,1471,15
kroB200.tsp,greedy-cycle,75,20595,18141,38736,2,15
kroA200.tsp,qc-ls,147,18976,18752,37728,859,15
kroA200.tsp,queue-ls,127,19978,19989,39967,870,15
kroB200.tsp,steepest-ls,31,19978,19028,39006,4833,15
kroA200.tsp,greedy-cycle,25,18273,17472,35745,2,15
kroB200.tsp,queue-ls,149,18505,19959,38464,836,15
kroA200.tsp,greedy-cycle,103,21116,17365,38481,2,15
kroA200.tsp,candidate-ls,123,20517,20075,40592,1476,15
kroA200.tsp,qc-ls,93,17763,21567,39330,784,15
kroB200.tsp,greedy-cycle,55,18449,21333,39782,3,15
kroB200.tsp,steepest-ls,89,18644,20003,38647,4775,15
kroA200.tsp,qc-ls,167,19567,19706,39273,838,15
kroB200.tsp,queue-ls,33,19161,18764,37925,852,15
kroA200.tsp,queue-ls,13,19506,19437,38943,822,15
kroB200.tsp,steepest-ls,183,18941,20189,39130,4805,15
kroA200.tsp,qc-ls,171,21524,18030,39554,874,15
kroB200.tsp,greedy-cycle,43,17675,20396,38071,3,15
kroA200.tsp,qc-ls,85,20383,19576,39959,805,15
kroA200.tsp,candidate-ls,135,18721,20271,38992,1432,15
kroA200.tsp,queue-ls,189,17685,20444,38129,877,15
kroB200.tsp,queue-ls,25,20521,18275,38796,890,15
kroB200.tsp,steepest-ls,195,19649,19058,38707,5295,15
kroB200.tsp,steepest-ls,27,19667,19379,39046,5181,15
kroA200.tsp,queue-ls,131,18292,19363,37655,848,15
kroA200.tsp,queue-ls,3,20155,19018,39173,898,15
kroA200.tsp,greedy-cycle,33,16943,20139,37082,2,15
kroA200.tsp,greedy-cycle,115,21596,18253,39849,2,15
kroA200.tsp,candidate-ls,119,18360,20444,38804,1491,15
kroA200.tsp,steepest-ls,171,19454,20181,39635,5217,15
kroB200.tsp,qc-ls,121,19519,19913,39432,845,15
kroB200.tsp,qc-ls,5,18187,19094,37281,818,15
kroB200.tsp,candidate-ls,27,18830,18727,37557,1630,15
kroB200.tsp,candidate-ls,147,19437,20417,39854,1560,15
kroB200.tsp,candidate-ls,1,19275,19842,39117,1492,15
kroA200.tsp,queue-ls,29,17691,21006,38697,875,15
kroA200.tsp,greedy-cycle,181,17402,18062,35464,2,15
kroB200.tsp,qc-ls,199,19798,19445,39243,863,15
kroA200.tsp,qc-ls,11,19465,19220,38685,802,15
kroB200.tsp,greedy-cycle,167,19404,19805,39209,2,15
kroA200.tsp,candidate-ls,57,20002,19377,39379,1467,15
kroA200.tsp,greedy-cycle,139,17722,22204,39926,2,15
kroA200.tsp,queue-ls,91,18317,19320,37637,825,15
kroB200.tsp,steepest-ls,101,19755,18662,38417,4842,15
kroB200.tsp,qc-ls,33,18291,19645,37936,790,15
kroA200.tsp,steepest-ls,67,17218,20619,37837,5163,15
kroB200.tsp,queue-ls,173,19267,19802,39069,837,15
kroB200.tsp,candidate-ls,89,19134,21127,40261,1425,15
kroB200.tsp,greedy-cycle,171,18713,20519,39232,2,15
kroA200.tsp,queue-ls,87,20430,18703,39133,804,15
kroA200.tsp,candidate-ls,41,20770,19122,39892,1452,15
kroB200.tsp,queue-ls,165,20753,18829,39582,833,15
kroA200.tsp,steepest-ls,71,19284,18940,38224,5229,15
kroB200.tsp,qc-ls,25,20807,19826,40633,762,15
kroB200.tsp,steepest-ls,117,19232,19951,39183,4680,15
kroA200.tsp,steepest-ls,167,19824,20026,39850,5209,15
kroB200.tsp,greedy-cycle,79,17024,19852,36876,2,15
kroB200.tsp,candidate-ls,31,19421,20137,39558,1464,15
kroB200.tsp,qc-ls,137,18775,20339,39114,855,15
kroA200.tsp,greedy-cycle,197,18444,18709,37153,2,15
kroB200.tsp,candidate-ls,151,20055,17985,38040,1510,15
kroA200.tsp,queue-ls,157,19665,20160,39825,824,15
kroA200.tsp,steepest-ls,183,20035,21192,41227,4808,15
kroB200.tsp,steepest-ls,41,18702,20724,39426,5020,15
kroA200.tsp,greedy-cycle,173,17924,17472,35396,2,15
kroB200.tsp,greedy-cycle,5,21149,18773,39922,2,15
kroB200.tsp,qc-ls,79,19305,19925,39230,778,15
kroA200.tsp,greedy-cycle,55,17553,20167,37720,2,15
kroB200.tsp,queue-ls,139,20643,19208,39851,852,15
kroB200.tsp,greedy-cycle,25,18449,21333,39782,2,15
kroA200.tsp,candidate-ls,153,16810,20503,37313,1537,15
kroA200.tsp,qc-ls,117,19437,18352,37789,799,15
kroB200.tsp,greedy-cycle,195,17918,20337,38255,2,15
kroA200.tsp,steepest-ls,95,18559,19250,37809,5079,15
kroB200.tsp,queue-ls,181,18917,18678,37595,837,15
kroA200.tsp,queue-ls,63,18584,19213,37797,810,15
kroB200.tsp,queue-ls,43,18741,19868,38609,876,15
kroB200.tsp,greedy-cycle,183,16949,21551,38500,2,15
kroA200.tsp,qc-ls,101,21013,18473,39486,875,15
kroA200.tsp,candidate-ls,145,18932,18504,37436,1613,15
kroB200.tsp,greedy-cycle,33,17191,21859,39050,2,15
kroB200.tsp,queue-ls,197,18550,22201,40751,824,15
kroA200.tsp,steepest-ls,83,19042,19500,38542,5212,15
kroB200.tsp,queue-ls,55,18591,19991,38582,885,15
kroA200.tsp,queue-ls,75,19605,18827,38432,830,15
kroB200.tsp,steepest-ls,57,20224,18473,38697,5223,15
kroA200.tsp,steepest-ls,195,17540,20024,37564,4796,15
kroA200.tsp,queue-ls,141,20028,18484,38512,910,15
kroA200.tsp,greedy-cycle,165,21116,17365,38481,2,15
kroA200.tsp,greedy-cycle,43,21596,18253,39849,2,15
kroB200.tsp,qc-ls,151,20252,17968,38220,753,15
kroB200.tsp,candidate-ls,57,20537,18958,39495,1556,15
kroA200.tsp,candidate-ls,169,18982,19765,38747,1555,15
kroA200.tsp,steepest-ls,101,18650,19816,38466,5055,15
kroB200.tsp,candidate-ls,137,19289,19057,38346,1517,15
kroA200.tsp,queue-ls,59,18671,18718,37389,859,15
kroB200.tsp,queue-ls,79,19526,18441,37967,824,15
kroA200.tsp,qc-ls,61,19012,19109,38121,848,15
kroB200.tsp,greedy-cycle,117,17783,20246,38029,2,15
kroA200.tsp,qc-ls,195,19101,18509,37610,856,15
kroA200.tsp,steepest-ls,17,19446,18344,37790,5210,15
kroB200.tsp,qc-ls,43,20252,18817,39069,812,15
kroB200.tsp,steepest-ls,171,21244,19363,40607,4893,15
kroB200.tsp,queue-ls,103,19810,20645,40455,808,15
kroA200.tsp,candidate-ls,27,18340,20438,38778,1455,15
kroA200.tsp,greedy-cycle,149,17669,22204,39873,2,15
kroA200.tsp,qc-ls,183,19718,17828,37546,893,15
kroB200.tsp,greedy-cycle,101,17626,20396,38022,2,15
kroA200.tsp,qc-ls,77,17997,20341,38338,802,15
kroB200.tsp,queue-ls,115,20192,19220,39412,816,15
kroA200.tsp,greedy-cycle,79,17733,22307,40040,2,15
kroB200.tsp,steepest-ls,167,19507,18661,38168,4756,15
kroB200.tsp,queue-ls,9,19397,20097,39494,895,15
kroB200.tsp,qc-ls,55,20423,18318,38741,875,15
kroB200.tsp,candidate-ls,199,18717,19480,38197,1598,15
kroA200.tsp,candidate-ls,31,19345,19641,38986,1488,15
kroB200.tsp,candidate-ls,41,18105,21144,39249,1529,15
kroB200.tsp,qc-ls,147,19081,19414,38495,840,15
kroA200.tsp,steepest-ls,117,19363,20423,39786,4963,15
kroB200.tsp,candidate-ls,121,18398,21449,39847,1463,15
kroA200.tsp,candidate-ls,89,19796,17821,37617,1454,15
kroB200.tsp,greedy-cycle,9,18658,21333,39991,2,15
kroA200.tsp,candidate-ls,11,19013,19812,38825,1609,15
kroB200.tsp,queue-ls,135,21600,20503,42103,841,15
kroA200.tsp,greedy-cycle,59,20757,17365,38122,2,15
kroB200.tsp,steepest-ls,147,19844,18539,38383,4915,15
kroB200.tsp,qc-ls,75,20121,20289,40410,777,15
kroA200.tsp,steepest-ls,21,20045,18015,38060,5149,15
kroB200.tsp,greedy-cycle,121,19306,17792,37098,2,15
kroA200.tsp,qc-ls,57,18578,18282,36860,789,15
kroB200.tsp,greedy-cycle,91,17606,20396,38002,2,15
kroA200.tsp,steepest-ls,99,19693,18254,37947,4803,15
kroB200.tsp,candidate-ls,101,20183,20977,41160,1413,15
kroA200.tsp,steepest-ls,137,19132,18682,37814,5356,15
kroB200.tsp,greedy-cycle,199,17705,20396,38101,2,15
kroB200.tsp,greedy-cycle,29,17090,20759,37849,2,15
kroB200.tsp,candidate-ls,61,19935,19352,39287,1542,15
kroB200.tsp,qc-ls,167,20704,20153,40857,864,15
kroB200.tsp,candidate-ls,117,18688,19463,38151,1423,15
kroA200.tsp,queue-ls,79,19418,18160,37578,845,15
kroB200.tsp,queue-ls,59,20637,18472,39109,847,15
kroA200.tsp,candidate-ls,149,20361,19133,39494,1439,15
kroB200.tsp,steepest-ls,1,18797,19696,38493,5144,15
kroA200.tsp,steepest-ls,121,18001,21458,39459,5178,15
kroB200.tsp,qc-ls,171,18141,19279,37420,808,15
kroB200.tsp,candidate-ls,77,20954,18901,39855,1380,15
kroA200.tsp,greedy-cycle,169,21163,17365,38528,2,15
kroA200.tsp,steepest-ls,37,18039,20610,38649,4863,15
kroB200.tsp,qc-ls,63,19443,19235,38678,854,15
kroB200.tsp,steepest-ls,151,18889,19068,37957,4801,15
kroB200.tsp,queue-ls,123,18716,21937,40653,826,15
kroB200.tsp,greedy-cycle,87,17701,20396,38097,2,15
kroA200.tsp,qc-ls,41,19200,19711,38911,813,15
kroB200.tsp,greedy-cycle,137,17061,19852,36913,2,15
kroA200.tsp,steepest-ls,199,19697,18638,38335,5273,15
kroB200.tsp,queue-ls,75,19168,21192,40360,840,15
kroA200.tsp,queue-ls,55,18842,19043,37885,813,15
kroA200.tsp,candidate-ls,93,18332,20413,38745,1552,15
kroA200.tsp,qc-ls,121,19716,20345,40061,769,15
kroA200.tsp,candidate-ls,165,19055,19552,38607,1593,15
kroB200.tsp,greedy-cycle,13,20857,18065,38922,3,15
kroA200.tsp,greedy-cycle,63,16452,21633,38085,2,15
kroA200.tsp,greedy-cycle,145,17061,20167,37228,2,15
kroA200.tsp,qc-ls,7,19022,21239,40261,817,15
kroB200.tsp,candidate-ls,183,18210,21009,39219,1488,15
kroB200.tsp,steepest-ls,77,19052,19573,38625,5149,15
kroA200.tsp,qc-ls,199,19853,18982,38835,807,15
kroA200.tsp,queue-ls,161,19926,20153,40079,806,15
kroB200.tsp,qc-ls,59,20402,19867,40269,836,15
kroB200.tsp,queue-ls,5,20778,20378,41156,784,15
kroA200.tsp,greedy-cycle,75,17669,22204,39873,2,15
kroB200.tsp,queue-ls,119,19427,18574,38001,829,15
kroB200.tsp,candidate-ls,195,21088,17798,38886,1430,15
kroA200.tsp,greedy-cycle,153,17722,22204,39926,2,15
kroA200.tsp,queue-ls,177,19425,18235,37660,747,15
kroB200.tsp,steepest-ls,61,19324,18174,37498,5131,15
kroA200.tsp,candidate-ls,85,18841,19206,38047,1420,15
kroA200.tsp,queue-ls,43,19732,19029,38761,819,15
kroB200.tsp,queue-ls,63,17608,21033,38641,894,15
kroA200.tsp,candidate-ls,7,18039,20893,38932,1506,15
kroA200.tsp,candidate-ls,173,20299,20628,40927,1517,15
kroA200.tsp,qc-ls,137,19645,19289,38934,867,15
kroB200.tsp,steepest-ls,37,18240,20628,38868,5114,15
kroA200.tsp,queue-ls,121,17216,20183,37399,867,15
kroA200.tsp,greedy-cycle,23,18374,17472,35846,2,15
kroA200.tsp,greedy-cycle,105,21345,18253,39598,2,15
kroA200.tsp,qc-ls,161,18218,19654,37872,816,15
kroA200.tsp,queue-ls,199,21240,19217,40457,862,15
kroA200.tsp,candidate-ls,125,20324,19519,39843,1469,15
kroB200.tsp,greedy-cycle,53,17634,20396,38030,3,15
kroA200.tsp,qc-ls,95,19584,20963,40547,840,15
kroB200.tsp,queue-ls,35,19805,18647,38452,814,15
kroA200.tsp,queue-ls,15,18694,20012,38706,892,15
kroB200.tsp,steepest-ls,185,18834,19447,38281,5327,15
kroA200.tsp,qc-ls,83,19389,18763,38152,912,15
kroB200.tsp,greedy-cycle,45,16972,21859,38831,2,15
kroA200.tsp,candidate-ls,133,19101,19117,38218,1446,15
kroA200.tsp,qc-ls,177,20595,18804,39399,859,15
kroB200.tsp,steepest-ls,99,20719,20538,41257,4717,15
kroB200.tsp,queue-ls,23,18884,20432,39316,843,15
kroB200.tsp,steepest-ls,193,19997,20336,40333,4952,15
kroA200.tsp,queue-ls,137,19256,19275,38531,857,15
kroB200.tsp,steepest-ls,21,18111,21130,39241,4787,15
kroA200.tsp,steepest-ls,9,20032,17787,37819,5706,15
kroA200.tsp,greedy-cycle,9,21703,18093,39796,2,15
kroA200.tsp,queue-ls,5,19233,18853,38086,806,15
kroB200.tsp,qc-ls,19,18107,19720,37827,820,15
kroA200.tsp,greedy-cycle,35,20643,18253,38896,2,15
kroB200.tsp,queue-ls,159,18626,19033,37659,879,15
kroA200.tsp,greedy-cycle,113,16990,20167,37157,2,15
kroA200.tsp,steepest-ls,177,19614,18295,37909,5276,15
kroB200.tsp,greedy-cycle,69,18256,21333,39589,2,15
kroB200.tsp,candidate-ls,21,20181,18270,38451,1534,15
kroB200.tsp,qc-ls,3,18542,21255,39797,808,15
kroB200.tsp,qc-ls,127,19427,19478,38905,844,15
kroB200.tsp,candidate-ls,7,19689,19282,38971,1432,15
kroA200.tsp,greedy-cycle,187,21596,18253,39849,2,15
kroB200.tsp,candidate-ls,141,18463,22606,41069,1442,15
kroB200.tsp,candidate-ls,99,20786,18728,39514,1543,15
kroB200.tsp,greedy-cycle,161,18049,20396,38445,2,15
kroA200.tsp,qc-ls,17,18107,19226,37333,859,15
kroA200.tsp,queue-ls,97,20301,19128,39429,782,15
kroA200.tsp,candidate-ls,51,20497,20014,40511,1430,15
kroB200.tsp,queue-ls,175,19279,19899,39178,844,15
kroA200.tsp,greedy-cycle,19,16452,21633,38085,4,15
kroB200.tsp,steepest-ls,107,19059,18696,37755,5558,15
kroB200.tsp,qc-ls,35,19056,20230,39286,843,15
kroA200.tsp,steepest-ls,61,18468,19396,37864,5027,15
kroB200.tsp,qc-ls,189,17816,19115,36931,839,15
kroB200.tsp,greedy-cycle,177,18113,20453,38566,2,15
kroA200.tsp,candidate-ls,47,19736,19342,39078,1580,15
kroA200.tsp,queue-ls,81,18873,20039,38912,869,15
kroA200.tsp,greedy-cycle,129,16872,20167,37039,2,15
kroA200.tsp,steepest-ls,77,19509,20574,40083,5013,15
kroB200.tsp,qc-ls,23,19071,17593,36664,851,15
kroB200.tsp,steepest-ls,111,18447,20445,38892,5250,15
kroB200.tsp,queue-ls,163,21163,17989,39152,812,15
kroA200.tsp,candidate-ls,109,19289,19537,38826,1508,15
kroA200.tsp,steepest-ls,161,18753,20198,38951,5346,15
kroB200.tsp,qc-ls,131,20085,20351,40436,772,15
kroB200.tsp,candidate-ls,37,19789,19085,38874,1340,15
kroB200.tsp,candidate-ls,157,20714,17904,38618,1541,15
kroA200.tsp,greedy-cycle,191,20806,18253,39059,2,15
kroA200.tsp,queue-ls,39,20278,18925,39203,844,15
kroB200.tsp,queue-ls,19,20965,21326,42291,765,15
kroA200.tsp,steepest-ls,57,18903,19497,38400,4961,15
kroB200.tsp,steepest-ls,131,20322,17359,37681,5190,15
kroB200.tsp,queue-ls,143,19203,18184,37387,838,15
kroA200.tsp,candidate-ls,67,19796,19028,38824,1361,15
kroA200.tsp,greedy-cycle,109,18068,17472,35540,2,15
kroB200.tsp,queue-ls,81,18328,20330,38658,892,15
kroA200.tsp,qc-ls,21,20062,19705,39767,884,15
kroA200.tsp,candidate-ls,191,18159,20296,38455,1526,15
kroB200.tsp,greedy-cycle,157,20595,18141,38736,2,15
kroB200.tsp,candidate-ls,177,18641,22336,40977,1545,15
kroA200.tsp,queue-ls,19,18162,21279,39441,851,15
kroB200.tsp,queue-ls,39,19312,19535,38847,869,15
kroB200.tsp,steepest-ls,189,19482,18247,37729,5302,15
kroA200.tsp,greedy-cycle,97,16990,20167,37157,2,15
kroB200.tsp,qc-ls,111,19189,18920,38109,815,15
kroB200.tsp,candidate-ls,17,20259,17955,38214,1526,15
kroA200.tsp,qc-ls,99,17814,18793,36607,1547,15
kroA200.tsp,candidate-ls,129,20987,19442,40429,1527,15
kroA200.tsp,queue-ls,195,19499,18963,38462,842,15
kroA200.tsp,steepest-ls,141,18280,19622,37902,5063,15
kroB200.tsp,steepest-ls,83,18293,22270,40563,4752,15
kroB200.tsp,candidate-ls,161,20412,18518,38930,1479,15
kroA200.tsp,greedy-cycle,81,18388,17472,35860,2,15
kroB200.tsp,qc-ls,107,19349,20365,39714,821,15
kroB200.tsp,steepest-ls,95,19262,20076,39338,5341,15
kroA200.tsp,steepest-ls,157,18558,20274,38832,5164,15
kroA200.tsp,queue-ls,183,21099,18304,39403,810,15
kroB200.tsp,greedy-cycle,49,17891,20396,38287,3,15
kroB200.tsp,queue-ls,155,21781,18144,39925,765,15
kroA200.tsp,greedy-cycle,39,18201,17472,35673,4,15
kroB200.tsp,steepest-ls,127,20418,19699,40117,4972,15
kroB200.tsp,qc-ls,15,20170,20740,40910,776,15
kroA200.tsp,steepest-ls,41,20825,18074,38899,5210,15
kroB200.tsp,queue-ls,97,19770,20228,39998,783,15
kroA200.tsp,candidate-ls,71,17526,20071,37597,1588,15
kroB200.tsp,greedy-cycle,141,17734,22443,40177,2,15
kroA200.tsp,candidate-ls,187,18857,19573,38430,1490,15
kroA200.tsp,qc-ls,37,19018,19984,39002,844,15
kroA200.tsp,queue-ls,9,18975,20227,39202,843,15
kroA200.tsp,greedy-cycle,5,17458,22307,39765,2,15
kroA200.tsp,steepest-ls,5,19253,19559,38812,5345,15
kroB200.tsp,qc-ls,81,20921,18569,39490,790,15
kroA200.tsp,queue-ls,23,19141,20351,39492,968,15
kroB200.tsp,greedy-cycle,65,17855,20510,38365,2,15
kroA200.tsp,candidate-ls,113,18835,20422,39257,1483,15
kroA200.tsp,qc-ls,157,20453,18795,39248,800,15
kroA200.tsp,greedy-cycle,133,16595,22671,39266,2,15
kroB200.tsp,qc-ls,39,19145,20045,39190,851,15
kroA200.tsp,greedy-cycle,15,18187,17472,35659,2,15
kroB200.tsp,queue-ls,179,18116,18581,36697,933,15
kroB200.tsp,qc-ls,193,18765,18765,37530,840,15
kroB200.tsp,candidate-ls,95,18937,18414,37351,1671,15
kroA200.tsp,queue-ls,117,19342,17838,37180,784,15
kroA200.tsp,greedy-cycle,125,21116,17365,38481,2,15
kroB200.tsp,candidate-ls,83,18847,20435,39282,1564,15
kroB200.tsp,qc-ls,185,19587,19898,39485,820,15
kroB200.tsp,steepest-ls,17,18697,19524,38221,5180,15
kroA200.tsp,queue-ls,101,18770,18565,37335,903,15
kroB200.tsp,qc-ls,97,18806,21168,39974,822,15
kroB200.tsp,queue-ls,15,18849,18951,37800,827,15
kroA200.tsp,queue-ls,35,19260,19302,38562,859,15
kroA200.tsp,qc-ls,141,17608,19963,37571,850,15
kroA200.tsp,candidate-ls,105,18892,18427,37319,1494,15
kroB200.tsp,greedy-cycle,73,17855,20510,38365,3,15
kroB200.tsp,candidate-ls,123,19833,20037,39870,1463,15
kroA200.tsp,steepest-ls,115,19172,18369,37541,5119,15
kroA200.tsp,qc-ls,139,18511,18338,36849,965,15
kroA200.tsp,candidate-ls,9,19089,19985,39074,1447,15
kroB200.tsp,qc-ls,145,19120,19587,38707,863,15
kroB200.tsp,candidate-ls,43,20044,19275,39319,1506,15
kroA200.tsp,candidate-ls,33,19496,20014,39510,1384,15
kroB200.tsp,steepest-ls,165,20496,18864,39360,4816,15
kroB200.tsp,qc-ls,57,20303,17779,38082,877,15
kroB200.tsp,queue-ls,117,19366,19549,38915,847,15
kroA200.tsp,queue-ls,179,17749,20481,38230,857,15
kroA200.tsp,qc-ls,75,18554,19266,37820,814,15
kroB200.tsp,greedy-cycle,103,17707,20396,38103,5,15
kroA200.tsp,qc-ls,181,19507,19368,38875,802,15
kroA200.tsp,candidate-ls,25,19191,20959,40150,1441,15
kroA200.tsp,qc-ls,9,19807,20415,40222,801,15
kroB200.tsp,queue-ls,101,20714,18824,39538,853,15
kroB200.tsp,qc-ls,41,17329,19024,36353,842,15
kroA200.tsp,steepest-ls,15,20084,17108,37192,5151,15
kroB200.tsp,steepest-ls,173,19434,18354,37788,5243,15
kroA200.tsp,qc-ls,197,19635,19310,38945,778,15
kroB200.tsp,greedy-cycle,115,17702,20396,38098,2,15
kroB200.tsp,steepest-ls,79,19825,18293,38118,5050,15
kroA200.tsp,qc-ls,63,19813,18242,38055,777,15
kroB200.tsp,candidate-ls,135,19366,19409,38775,1522,15
kroA200.tsp,steepest-ls,103,19993,18716,38709,4980,15
kroB200.tsp,candidate-ls,55,19752,20246,39998,1504,15
kroB200.tsp,qc-ls,153,21408,19593,41001,785,15
kroA200.tsp,steepest-ls,39,18840,19843,38683,5080,15
kroA200.tsp,greedy-cycle,41,16614,21633,38247,2,15
kroA200.tsp,greedy-cycle,167,17636,21615,39251,2,15
kroA200.tsp,queue-ls,143,18741,18120,36861,805,15
kroB200.tsp,greedy-cycle,89,16866,22271,39137,2,15
kroA200.tsp,steepest-ls,197,19084,18999,38083,5120,15
kroB200.tsp,steepest-ls,55,19556,18043,37599,5186,15
kroB200.tsp,greedy-cycle,139,17823,20268,38091,2,15
kroB200.tsp,candidate-ls,119,19810,18728,38538,1507,15
kroB200.tsp,queue-ls,57,20934,17269,38203,871,15
kroA200.tsp,queue-ls,77,18567,19651,38218,885,15
kroA200.tsp,steepest-ls,81,19649,19162,38811,4981,15
kroB200.tsp,queue-ls,195,19610,20968,40578,803,15
kroB200.tsp,candidate-ls,79,19042,18911,37953,1489,15
kroA200.tsp,candidate-ls,147,21070,18085,39155,1427,15
kroB200.tsp,greedy-cycle,31,20210,18102,38312,2,15
kroA200.tsp,qc-ls,103,19045,19164,38209,885,15
kroB200.tsp,greedy-cycle,181,21255,18773,40028,3,15
kroA200.tsp,queue-ls,61,20177,19678,39855,839,15
kroB200.tsp,queue-ls,41,17622,20784,38406,831,15
kroB200.tsp,queue-ls,183,19866,20046,39912,772,15
kroA200.tsp,steepest-ls,97,18023,19455,37478,5042,15
kroB200.tsp,qc-ls,169,17734,19842,37576,894,15
kroB200.tsp,greedy-cycle,197,18256,21333,39589,2,15
kroA200.tsp,qc-ls,115,20231,17910,38141,823,15
kroA200.tsp,steepest-ls,139,17870,19383,37253,4955,15
kroB200.tsp,greedy-cycle,27,20595,18141,38736,2,15
kroA200.tsp,candidate-ls,151,20527,18129,38656,1473,15
kroA200.tsp,greedy-cycle,57,17168,20167,37335,2,15
kroB200.tsp,steepest-ls,149,19670,18295,37965,5350,15
kroA200.tsp,greedy-cycle,171,17924,17472,35396,2,15
kroB200.tsp,greedy-cycle,7,20711,18141,38852,2,15
kroB200.tsp,steepest-ls,43,19289,19755,39044,5090,15
kroA200.tsp,steepest-ls,181,19892,18110,38002,4998,15
kroA200.tsp,qc-ls,59,19307,18303,37610,807,15
kroA200.tsp,queue-ls,155,17275,22129,39404,874,15
kroA200.tsp,qc-ls,135,18415,21352,39767,829,15
kroA200.tsp,steepest-ls,119,19259,19990,39249,4807,15
kroA200.tsp,candidate-ls,171,20012,17985,37997,1467,15
kroB200.tsp,qc-ls,149,19976,19608,39584,782,15
kroA200.tsp,candidate-ls,5,20026,18965,38991,1556,15
kroA200.tsp,queue-ls,41,19488,19547,39035,879,15
kroB200.tsp,queue-ls,61,19428,21562,40990,861,15
kroA200.tsp,candidate-ls,87,20217,19094,39311,1544,15
kroB200.tsp,steepest-ls,63,20193,18380,38573,5206,15
kroA200.tsp,qc-ls,79,20192,18908,39100,811,15
kroA200.tsp,queue-ls,175,20427,19119,39546,867,15
kroA200.tsp,greedy-cycle,151,18317,21615,39932,2,15
kroB200.tsp,candidate-ls,197,20047,20064,40111,1455,15
kroA200.tsp,greedy-cycle,77,18388,17472,35860,2,15
kroB200.tsp,queue-ls,7,19117,19509,38626,902,15
kroB200.tsp,steepest-ls,169,19062,20830,39892,4983,15
kroA200.tsp,queue-ls,163,20566,18294,38860,895,15
kroB200.tsp,steepest-ls,75,21271,19616,40887,4868,15
kroB200.tsp,greedy-cycle,119,21106,17142,38248,4,15
kroA200.tsp,qc-ls,5,18982,21628,40610,840,15
kroB200.tsp,candidate-ls,181,19281,20383,39664,1397,15
kroA200.tsp,candidate-ls,29,18920,19565,38485,1452,15
kroA200.tsp,greedy-cycle,147,16872,20167,37039,2,15
kroA200.tsp,steepest-ls,19,20376,20029,40405,5166,15
kroA200.tsp,greedy-cycle,61,17202,20167,37369,2,15
kroA200.tsp,candidate-ls,167,19128,19497,38625,1594,15
kroB200.tsp,greedy-cycle,11,20257,18102,38359,6,15
kroA200.tsp,qc-ls,123,20301,18010,38311,883,15
kroB200.tsp,candidate-ls,59,18872,19611,38483,1555,15
kroB200.tsp,candidate-ls,139,20114,17946,38060,1495,15
kroA200.tsp,candidate-ls,91,17214,20715,37929,1433,15
kroB200.tsp,queue-ls,77,19799,19211,39010,797,15
kroA200.tsp,queue-ls,57,18066,20154,38220,858,15
kroB200.tsp,greedy-cycle,135,20326,18102,38428,3,15
kroB200.tsp,steepest-ls,59,20350,19015,39365,4932,15
kroB200.tsp,greedy-cycle,85,17075,19852,36927,5,15
kroA200.tsp,qc-ls,43,18950,20120,39070,838,15
kroB200.tsp,queue-ls,121,18871,20731,39602,886,15
kroB200.tsp,qc-ls,61,18673,19873,38546,860,15
kroA200.tsp,steepest-ls,35,18084,18146,36230,5350,15
kroB200.tsp,steepest-ls,153,20414,19311,39725,5093,15
kroB200.tsp,candidate-ls,75,19432,19283,38715,1434,15
kroB200.tsp,qc-ls,173,18469,19090,37559,924,15
kroA200.tsp,steepest-ls,123,19900,17878,37778,4995,15
kroB200.tsp,steepest-ls,3,19227,19467,38694,4982,15
kroB200.tsp,candidate-ls,115,18934,18960,37894,1527,15
kroB200.tsp,queue-ls,199,19274,20786,40060,815,15
kroB200.tsp,qc-ls,165,20984,19448,40432,829,15
kroB200.tsp,candidate-ls,63,19486,19480,38966,1459,15
kroA200.tsp,steepest-ls,135,16534,20164,36698,4956,15
kroA200.tsp,qc-ls,119,19579,18914,38493,813,15
kroB200.tsp,candidate-ls,103,19202,19707,38909,1469,15
kroA200.tsp,queue-ls,159,18243,20358,38601,820,15
kroA200.tsp,qc-ls,55,18346,21260,39606,813,15
kroB200.tsp,greedy-cycle,93,17191,21859,39050,4,15
kroB200.tsp,greedy-cycle,123,18157,20656,38813,2,15
kroB200.tsp,steepest-ls,145,19437,20188,39625,5041,15
kroA200.tsp,steepest-ls,23,19516,20528,40044,5099,15
kroB200.tsp,qc-ls,77,20763,18616,39379,830,15
kroB200.tsp,queue-ls,137,19322,19840,39162,822,15
kroA200.tsp,candidate-ls,13,17731,19991,37722,1528,15
kroA200.tsp,greedy-cycle,193,21326,18253,39579,2,15
kroB200.tsp,candidate-ls,155,20337,17946,38283,1488,15
kroB200.tsp,qc-ls,99,19416,19995,39411,786,15
kroB200.tsp,candidate-ls,35,19818,19081,38899,1460,15
kroB200.tsp,qc-ls,133,18419,19842,38261,767,15
kroA200.tsp,steepest-ls,163,20022,20194,40216,5272,15
kroB200.tsp,queue-ls,161,21078,19638,40716,819,15
kroB200.tsp,qc-ls,21,18974,20060,39034,774,15
kroA200.tsp,steepest-ls,75,18484,19806,38290,5153,15
kroB200.tsp,steepest-ls,113,18626,19192,37818,5226,15
kroA200.tsp,queue-ls,83,20077,17914,37991,878,15
kroA200.tsp,candidate-ls,45,18523,19690,38213,1540,15
kroB200.tsp,greedy-cycle,175,17307,21859,39166,2,15
kroB200.tsp,steepest-ls,19,20599,18997,39596,5028,15
kroB200.tsp,steepest-ls,105,20434,18886,39320,4877,15
kroA200.tsp,steepest-ls,63,17975,19416,37391,5116,15
kroB200.tsp,qc-ls,37,19084,20233,39317,835,15
kroB200.tsp,queue-ls,177,19168,20204,39372,805,15
kroA200.tsp,candidate-ls,53,20976,17391,38367,1453,15
kroA200.tsp,queue-ls,95,18127,20035,38162,848,15
kroA200.tsp,queue-ls,119,18066,21256,39322,804,15
kroA200.tsp,qc-ls,15,18885,18562,37447,879,15
kroB200.tsp,greedy-cycle,163,17891,20396,38287,2,15
kroB200.tsp,candidate-ls,143,19170,19552,38722,1607,15
kroB200.tsp,candidate-ls,5,18778,19650,38428,1419,15
kroA200.tsp,greedy-cycle,185,16614,21633,38247,2,15
kroB200.tsp,qc-ls,1,19721,19805,39526,803,15
kroB200.tsp,qc-ls,125,19665,17988,37653,795,15
kroB200.tsp,candidate-ls,23,19667,19520,39187,1418,15
kroA200.tsp,steepest-ls,175,19002,17680,36682,5536,15
kroA200.tsp,qc-ls,159,19776,19870,39646,800,15
kroA200.tsp,greedy-cycle,111,16484,22671,39155,5,15
kroB200.tsp,queue-ls,99,20042,21288,41330,889,15
kroA200.tsp,greedy-cycle,37,16872,20167,37039,2,15
kroB200.tsp,steepest-ls,129,20086,19791,39877,5235,15
kroA200.tsp,queue-ls,7,19214,19721,38935,823,15
kroB200.tsp,steepest-ls,23,19173,20810,39983,5005,15
kroA200.tsp,qc-ls,39,18755,19039,37794,789,15
kroA200.tsp,candidate-ls,189,18965,19602,38567,1592,15
kroA200.tsp,queue-ls,135,18835,21368,40203,817,15
kroB200.tsp,steepest-ls,191,20887,18198,39085,5289,15
kroB200.tsp,queue-ls,21,18139,19099,37238,829,15
kroA200.tsp,qc-ls,175,19226,18605,37831,927,15
kroA200.tsp,steepest-ls,159,18641,21444,40085,5212,15
kroA200.tsp,qc-ls,81,20559,19728,40287,816,15
kroB200.tsp,greedy-cycle,47,21187,18065,39252,4,15
kroA200.tsp,candidate-ls,131,20247,19909,40156,1419,15
kroB200.tsp,qc-ls,109,19741,20782,40523,803,15
kroB200.tsp,steepest-ls,187,20718,19429,40147,5216,15
kroA200.tsp,greedy-cycle,99,20645,17365,38010,6,15
kroB200.tsp,candidate-ls,179,19147,19893,39040,1329,15
kroB200.tsp,queue-ls,37,19565,19675,39240,806,15
kroA200.tsp,queue-ls,17,19755,17849,37604,826,15
kroA200.tsp,candidate-ls,127,19317,20751,40068,1422,15
kroB200.tsp,greedy-cycle,51,22356,17475,39831,3,15
kroA200.tsp,qc-ls,97,19484,20612,40096,905,15
kroA200.tsp,qc-ls,163,20675,19433,40108,848,15
kroB200.tsp,candidate-ls,19,18445,18720,37165,1617,15
kroA200.tsp,candidate-ls,69,19718,21043,40761,1410,15
kroA200.tsp,greedy-cycle,107,20806,18253,39059,2,15
kroA200.tsp,steepest-ls,59,19217,18859,38076,5225,15
kroA200.tsp,greedy-cycle,21,16595,22671,39266,2,15
kroA200.tsp,queue-ls,123,19981,17577,37558,869,15
kroB200.tsp,steepest-ls,35,19381,19408,38789,5018,15
kroB200.tsp,greedy-cycle,159,17786,20396,38182,2,15
kroB200.tsp,candidate-ls,39,18910,19926,38836,1414,15
kroA200.tsp,candidate-ls,107,19552,20086,39638,1394,15
kroB200.tsp,greedy-cycle,71,17065,21551,38616,2,15
kroA200.tsp,qc-ls,143,19383,20773,40156,857,15
kroB200.tsp,candidate-ls,159,19484,20423,39907,1513,15
kroB200.tsp,queue-ls,17,18116,20833,38949,814,15
kroA200.tsp,queue-ls,37,18576,19970,38546,872,15
kroB200.tsp,qc-ls,95,19549,19448,38997,760,15
kroA200.tsp,queue-ls,103,19175,19109,38284,868,15
kroB200.tsp,steepest-ls,15,19932,20083,40015,4804,15
kroB200.tsp,greedy-cycle,179,17307,21859,39166,2,15
kroB200.tsp,qc-ls,187,20306,20710,41016,775,15
kroB200.tsp,candidate-ls,81,18059,21133,39192,1463,15
kroA200.tsp,steepest-ls,79,17967,18732,36699,4893,15
kroA200.tsp,candidate-ls,49,18288,20329,38617,1347,15
kroA200.tsp,greedy-cycle,127,20933,18253,39186,3,15
kroA200.tsp,qc-ls,19,19171,19437,38608,850,15
kroA200.tsp,queue-ls,115,20668,17532,38200,842,15
kroB200.tsp,candidate-ls,97,17441,19260,36701,1463,15
kroB200.tsp,qc-ls,191,17669,19576,37245,843,15
kroA200.tsp,greedy-cycle,17,18068,17472,35540,2,15
kroB200.tsp,steepest-ls,109,19336,18482,37818,5338,15
kroA200.tsp,greedy-cycle,131,18444,18709,37153,2,15
kroA200.tsp,queue-ls,99,18951,18185,37136,940,15
kroB200.tsp,qc-ls,129,19480,19227,38707,890,15
kroA200.tsp,qc-ls,155,20408,19340,39748,849,15
kroA200.tsp,steepest-ls,179,18246,19984,38230,5228,15
kroB200.tsp,greedy-cycle,67,18658,21333,39991,2,15
kroA200.tsp,candidate-ls,111,19799,18630,38429,1559,15
kroA200.tsp,queue-ls,21,19433,17434,36867,863,15
kroA200.tsp,greedy-cycle,189,21345,18253,39598,6,15
kroB200.tsp,candidate-ls,9,18644,19356,38000,1494,15
kroB200.tsp,qc-ls,83,18776,21346,40122,819,15
kroA200.tsp,greedy-cycle,7,16595,22671,39266,2,15
kroA200.tsp,steepest-ls,7,18568,18988,37556,5183,15
kroA200.tsp,queue-ls,139,19989,18205,38194,845,15
kroA200.tsp,candidate-ls,185,19018,21184,40202,1471,15
kroA200.tsp,qc-ls,35,18000,18928,36928,858,15
kroB200.tsp,greedy-cycle,143,17786,20396,38182,2,15
kroA200.tsp,candidate-ls,73,19577,19847,39424,1641,15
kroB200.tsp,queue-ls,95,17884,20578,38462,827,15
kroB200.tsp,steepest-ls,125,19180,19959,39139,5069,15
kroA200.tsp,steepest-ls,43,18661,20460,39121,4904,15
kroB200.tsp,qc-ls,17,20456,19406,39862,813,15
kroB200.tsp,queue-ls,157,20061,17809,37870,854,15
kroA200.tsp,queue-ls,181,19448,18496,37944,866,15
kroA200.tsp,steepest-ls,155,19526,19176,38702,5738,15
kroB200.tsp,steepest-ls,97,19207,17926,37133,5312,15
kroA200.tsp,qc-ls,179,18504,20835,39339,826,15
kroB200.tsp,qc-ls,105,20693,18662,39355,892,15
kroA200.tsp,greedy-cycle,83,21163,17365,38528,2,15
kroB200.tsp,candidate-ls,163,18727,19886,38613,1425,15
kroB200.tsp,steepest-ls,81,19444,19104,38548,5042,15
kroA200.tsp,steepest-ls,143,19141,19789,38930,5124,15
kroA200.tsp,queue-ls,197,19226,20060,39286,791,15
kroB200.tsp,candidate-ls,15,19787,20080,39867,1484,15
kroB200.tsp,qc-ls,113,20338,19462,39800,775,15
kroA200.tsp,greedy-cycle,95,21218,17365,38583,3,15
kroB200.tsp,candidate-ls,175,19994,19290,39284,1400,15
kroB200.tsp,greedy-cycle,155,21187,18065,39252,2,15
kroB200.tsp,steepest-ls,39,18679,20469,39148,5052,15
kroA200.tsp,qc-ls,23,18751,19858,38609,825,15
kroA200.tsp,candidate-ls,193,18819,17783,36602,1488,15
kroB200.tsp,queue-ls,83,18960,20577,39537,803,15
kroA200.tsp,candidate-ls,65,21296,19291,40587,1492,15
kroB200.tsp,queue-ls,141,19040,18744,37784,872,15
kroA200.tsp,steepest-ls,55,19449,18984,38433,5613,15
kroB200.tsp,steepest-ls,133,18809,20251,39060,5121,15
kroA200.tsp,candidate-ls,177,18689,19608,38297,1489,15
kroA200.tsp,qc-ls,133,20435,17837,38272,840,15
kroA200.tsp,candidate-ls,3,18894,18480,37374,1561,15
kroB200.tsp,candidate-ls,49,18488,20844,39332,1592,15
kroA200.tsp,candidate-ls,81,19814,21106,40920,1579,15
kroB200.tsp,candidate-ls,129,20673,19600,40273,1463,15
kroA200.tsp,queue-ls,47,19850,18083,37933,795,15
kroB200.tsp,queue-ls,67,20502,18715,39217,822,15
kroA200.tsp,queue-ls,173,18755,18703,37458,788,15
kroB200.tsp,greedy-cycle,109,21038,18065,39103,2,15
kroB200.tsp,steepest-ls,65,18680,19166,37846,5351,15
kroA200.tsp,candidate-ls,39,18989,18061,37050,1503,15
kroB200.tsp,candidate-ls,191,19978,19924,39902,1459,15
kroA200.tsp,greedy-cycle,157,17191,22196,39387,2,15
kroB200.tsp,queue-ls,1,20213,19301,39514,808,15
kroA200.tsp,greedy-cycle,71,16872,20167,37039,2,15
kroB200.tsp,steepest-ls,73,18951,20307,39258,4995,15
kroA200.tsp,queue-ls,165,19820,19495,39315,887,15
kroA200.tsp,qc-ls,69,18301,20579,38880,844,15
kroA200.tsp,greedy-cycle,141,21332,18093,39425,2,15
kroB200.tsp,candidate-ls,187,17828,19550,37378,1543,15
kroA200.tsp,qc-ls,3,18990,19021,38011,815,15
kroA200.tsp,greedy-cycle,67,18327,19625,37952,2,15
kroB200.tsp,steepest-ls,179,19253,19315,38568,5191,15
kroA200.tsp,steepest-ls,109,18395,18730,37125,5212,15
kroA200.tsp,qc-ls,125,17882,20647,38529,801,15
kroA200.tsp,candidate-ls,161,19764,20745,40509,1511,15
kroB200.tsp,greedy-cycle,17,17976,20396,38372,3,15
kroB200.tsp,qc-ls,159,19924,19543,39467,846,15
kroB200.tsp,queue-ls,71,18984,19448,38432,796,15
kroA200.tsp,queue-ls,51,19492,19218,38710,807,15
kroA200.tsp,candidate-ls,97,18790,18703,37493,1447,15
kroA200.tsp,qc-ls,45,19219,21071,40290,799,15
kroB200.tsp,greedy-cycle,83,17191,21859,39050,2,15
kroA200.tsp,queue-ls,149,19416,21234,40650,860,15
kroB200.tsp,greedy-cycle,133,17090,20759,37849,2,15
kroB200.tsp,qc-ls,67,17363,20163,37526,832,15
kroA200.tsp,steepest-ls,33,20022,19299,39321,5188,15
kroB200.tsp,steepest-ls,155,19758,18794,38552,5120,15
kroB200.tsp,queue-ls,127,19774,21364,41138,882,15
kroB200.tsp,qc-ls,175,18308,20284,38592,822,15
kroB200.tsp,candidate-ls,73,21538,19376,40914,1525,15
kroB200.tsp,steepest-ls,5,19791,19127,38918,5349,15
kroA200.tsp,qc-ls,109,19569,20423,39992,796,15
kroA200.tsp,steepest-ls,125,18085,20464,38549,5020,15
kroB200.tsp,candidate-ls,113,20021,18485,38506,1443,15
kroB200.tsp,candidate-ls,65,19900,19782,39682,1610,15
kroB200.tsp,qc-ls,163,18745,20304,39049,817,15
kroA200.tsp,steepest-ls,133,18923,18227,37150,5511,15
kroB200.tsp,candidate-ls,105,20360,18208,38568,1497,15
kroB200.tsp,queue-ls,189,19084,18876,37960,868,15
kroB200.tsp,steepest-ls,49,18642,19527,38169,5190,15
kroB200.tsp,greedy-cycle,125,21486,18065,39551,2,15
kroB200.tsp,greedy-cycle,95,17685,20396,38081,2,15
kroA200.tsp,qc-ls,53,19874,18326,38200,780,15
kroB200.tsp,queue-ls,131,18600,19425,38025,776,15
kroB200.tsp,steepest-ls,143,18147,21180,39327,4872,15
kroA200.tsp,steepest-ls,25,19469,18980,38449,5250,15
kroB200.tsp,qc-ls,71,19253,19958,39211,799,15
kroA200.tsp,candidate-ls,15,18476,19779,38255,1504,15
kroB200.tsp,candidate-ls,125,20089,18952,39041,1470,15
kroA200.tsp,steepest-ls,113,20250,18139,38389,5291,15
kroB200.tsp,candidate-ls,45,20531,19997,40528,1354,15
kroB200.tsp,qc-ls,143,17713,20859,38572,873,15
kroA200.tsp,candidate-ls,35,20072,19119,39191,1509,15
kroB200.tsp,queue-ls,111,18614,19353,37967,883,15
kroB200.tsp,steepest-ls,163,19205,17869,37074,5446,15
kroB200.tsp,qc-ls,51,20092,17622,37714,836,15
kroB200.tsp,steepest-ls,69,19547,19796,39343,4882,15
kroB200.tsp,greedy-cycle,105,17823,20268,38091,2,15
kroA200.tsp,qc-ls,187,21227,19163,40390,827,15
kroA200.tsp,qc-ls,73,20202,20134,40336,784,15
kroA200.tsp,candidate-ls,23,19062,19432,38494,1576,15
kroB200.tsp,qc-ls,47,20353,19116,39469,798,15
kroA200.tsp,steepest-ls,13,20157,18871,39028,5219,15
kroB200.tsp,steepest-ls,175,19675,19536,39211,4968,15
kroB200.tsp,queue-ls,107,19404,18873,38277,863,15
kroA200.tsp,qc-ls,65,20508,18588,39096,809,15
kroA200.tsp,queue-ls,169,19745,20633,40378,928,15
kroA200.tsp,qc-ls,191,20653,18323,38976,835,15
kroB200.tsp,greedy-cycle,113,17855,20510,38365,4,15
kroB200.tsp,candidate-ls,133,18880,21176,40056,1437,15
kroA200.tsp,qc-ls,129,20263,19223,39486,837,15
kroA200.tsp,steepest-ls,105,19918,18548,38466,5197,15
kroB200.tsp,qc-ls,155,20919,19131,40050,820,15
kroB200.tsp,candidate-ls,53,19836,18779,38615,1524,15
kroA200.tsp,greedy-cycle,47,21179,17365,38544,2,15
kroB200.tsp,steepest-ls,159,18694,19518,38212,5396,15
kroA200.tsp,greedy-cycle,161,16452,21633,38085,2,15
kroA200.tsp,steepest-ls,191,17225,18634,35859,4972,15
kroB200.tsp,steepest-ls,53,18590,18903,37493,5086,15
kroA200.tsp,queue-ls,145,20543,17702,38245,843,15
kroA200.tsp,qc-ls,49,17854,20799,38653,910,15
kroB200.tsp,queue-ls,51,19864,18598,38462,867,15
kroA200.tsp,queue-ls,71,18559,19599,38158,934,15
kroB200.tsp,queue-ls,193,17795,21399,39194,933,15
kroA200.tsp,steepest-ls,87,19543,21488,41031,4952,15
kroB200.tsp,qc-ls,179,20239,19490,39729,804,15
kroA200.tsp,steepest-ls,129,19047,19558,38605,5018,15
kroA200.tsp,qc-ls,105,21118,18272,39390,882,15
kroB200.tsp,greedy-cycle,187,18164,20656,38820,2,15
kroA200.tsp,candidate-ls,141,18942,19067,38009,1583,15
kroB200.tsp,steepest-ls,9,19410,18847,38257,5066,15
kroB200.tsp,greedy-cycle,37,17024,19852,36876,4,15
kroB200.tsp,candidate-ls,109,19393,20046,39439,1417,15
kroA200.tsp,queue-ls,67,19433,20991,40424,813,15
kroB200.tsp,queue-ls,47,19574,18100,37674,805,15
kroA200.tsp,steepest-ls,91,20611,18635,39246,5003,15
kroB200.tsp,queue-ls,185,20610,20015,40625,788,15
kroB200.tsp,candidate-ls,69,19620,18718,38338,1533,15
kroB200.tsp,greedy-cycle,21,17701,20396,38097,2,15
kroA200.tsp,candidate-ls,157,18337,19582,37919,1595,15
kroB200.tsp,greedy-cycle,191,18987,16849,35836,2,15
kroA200.tsp,qc-ls,113,18217,18604,36821,840,15
kroA200.tsp,steepest-ls,29,19814,19840,39654,4901,15
kroA200.tsp,greedy-cycle,51,21265,17365,38630,3,15
kroA200.tsp,candidate-ls,19,19681,17265,36946,1485,15
kroB200.tsp,greedy-cycle,1,21032,18065,39097,2,15
kroA200.tsp,greedy-cycle,177,18317,21615,39932,2,15
kroB200.tsp,greedy-cycle,99,18449,21333,39782,2,15
kroA200.tsp,queue-ls,153,18375,21067,39442,900,15
kroB200.tsp,greedy-cycle,129,17705,20396,38101,2,15
kroB200.tsp,steepest-ls,45,18948,19185,38133,4870,15
kroA200.tsp,steepest-ls,187,19650,20449,40099,4960,15
kroB200.tsp,qc-ls,139,19177,21228,40405,752,15
kroA200.tsp,steepest-ls,169,17921,18540,36461,5438,15
kroA200.tsp,qc-ls,145,21742,17873,39615,775,15
kroA200.tsp,candidate-ls,101,20787,19035,39822,1484,15
kroB200.tsp,greedy-cycle,77,18562,16849,35411,2,15
kroB200.tsp,queue-ls,11,19713,17733,37446,774,15
kroA200.tsp,greedy-cycle,199,17168,20167,37335,2,15
kroA200.tsp,queue-ls,31,19077,20149,39226,820,15
kroB200.tsp,qc-ls,93,19015,20084,39099,833,15
kroB200.tsp,steepest-ls,13,19855,18319,38174,5366,15
kroA200.tsp,queue-ls,105,18837,18558,37395,880,15
kroB200.tsp,candidate-ls,87,20315,19866,40181,1530,15
kroB200.tsp,qc-ls,181,19841,20760,40601,822,15
kroB200.tsp,steepest-ls,119,20605,17492,38097,5068,15
kroA200.tsp,queue-ls,89,18947,19346,38293,841,15
kroA200.tsp,greedy-cycle,121,21596,18253,39849,2,15
kroA200.tsp,queue-ls,113,19938,17859,37797,851,15
kroB200.tsp,greedy-cycle,169,18256,21333,39589,2,15
kroB200.tsp,qc-ls,197,19595,18603,38198,825,15
kroB200.tsp,candidate-ls,91,19028,19446,38474,1503,15
kroA200.tsp,steepest-ls,69,19153,20651,39804,5331,15
kroA200.tsp,greedy-cycle,11,18201,17472,35673,2,15
kroA200.tsp,candidate-ls,59,19490,20568,40058,1467,15
kroA200.tsp,greedy-cycle,137,18388,17472,35860,2,15
kroB200.tsp,candidate-ls,29,18500,18833,37333,1535,15
kroB200.tsp,greedy-cycle,61,17127,20759,37886,2,15
kroA200.tsp,candidate-ls,117,20831,19934,40765,1570,15
kroA200.tsp,qc-ls,153,19538,19699,39237,860,15
kroB200.tsp,candidate-ls,149,20844,18260,39104,1487,15
kroA200.tsp,queue-ls,27,18911,19515,38426,887,15
kroB200.tsp,qc-ls,85,19900,18813,38713,816,15
kroA200.tsp,steepest-ls,1,19869,19082,38951,5237,15
kroA200.tsp,greedy-cycle,1,18327,19625,37952,2,15
kroB200.tsp,steepest-ls,29,19037,18842,37879,5050,15
kroB200.tsp,greedy-cycle,145,16995,21859,38854,2,15
kroA200.tsp,candidate-ls,183,18366,19229,37595,1579,15
kroA200.tsp,qc-ls,33,19610,17781,37391,837,15
kroB200.tsp,queue-ls,93,18882,19933,38815,806,15
kroA200.tsp,candidate-ls,75,18324,19515,37839,1491,15
kroB200.tsp,queue-ls,151,21464,18614,40078,759,15
kroB200.tsp,steepest-ls,123,18494,20755,39249,5271,15
kroA200.tsp,steepest-ls,45,19222,20888,40110,4793,15
kroB200.tsp,qc-ls,11,19550,18544,38094,854,15
kroA200.tsp,steepest-ls,153,17738,19934,37672,4832,15
kroB200.tsp,steepest-ls,91,17280,19385,36665,5326,15
kroA200.tsp,queue-ls,187,21061,19221,40282,775,15
kroB200.tsp,qc-ls,103,18337,20048,38385,882,15
kroA200.tsp,greedy-cycle,85,17534,21403,38937,2,15
kroB200.tsp,candidate-ls,165,19369,19524,38893,1499,15
kroA200.tsp,queue-ls,191,17397,20413,37810,837,15
kroA200.tsp,qc-ls,169,19717,21549,41266,806,15
kroB200.tsp,steepest-ls,87,21444,19709,41153,4767,15
kroA200.tsp,steepest-ls,145,19013,18907,37920,5536,15
kroB200.tsp,qc-ls,115,18848,18995,37843,865,15
kroB200.tsp,candidate-ls,13,19836,19840,39676,1442,15
kroA200.tsp,greedy-cycle,93,17888,22204,40092,2,15
kroB200.tsp,candidate-ls,173,20763,18612,39375,1476,15
kroA200.tsp,qc-ls,25,18619,19272,37891,864,15
kroA200.tsp,candidate-ls,195,18368,18968,37336,1571,15
kroA200.tsp,queue-ls,129,18415,18194,36609,859,15
kroB200.tsp,greedy-cycle,153,17634,20396,38030,4,15
kroA200.tsp,candidate-ls,63,17954,18618,36572,1491,15
kroB200.tsp,queue-ls,85,20423,20718,41141,845,15
kroA200.tsp,steepest-ls,53,20220,19096,39316,5371,15
kroB200.tsp,steepest-ls,135,18635,21372,40007,5152,15
kroB200.tsp,queue-ls,147,20224,18900,39124,897,15
kroB200.tsp,candidate-ls,153,18604,19515,38119,1528,15
kroA200.tsp,greedy-cycle,195,18317,21615,39932,3,15
kroB200.tsp,qc-ls,135,19315,20040,39355,845,15
kroB200.tsp,candidate-ls,33,19250,19775,39025,1383,15
kroA200.tsp,qc-ls,149,18077,19341,37418,867,15
kroA200.tsp,steepest-ls,165,19301,20604,39905,5067,15
kroB200.tsp,qc-ls,27,18558,20059,38617,765,15
kroA200.tsp,steepest-ls,73,21503,18295,39798,5070,15
kroB200.tsp,steepest-ls,115,20182,19084,39266,4923,15
kroB200.tsp,queue-ls,167,19100,19477,38577,855,15
kroA200.tsp,candidate-ls,43,22496,17166,39662,1492,15
kroA200.tsp,queue-ls,85,18674,18488,37162,920,15
kroA200.tsp,queue-ls,109,19918,18293,38211,840,15
kroB200.tsp,greedy-cycle,173,20373,18102,38475,2,15
kroB200.tsp,queue-ls,171,20062,20840,40902,806,15
kroB200.tsp,steepest-ls,103,18981,18330,37311,5423,15
kroA200.tsp,steepest-ls,65,18649,21025,39674,5209,15
kroB200.tsp,qc-ls,31,19791,19808,39599,772,15
kroA200.tsp,queue-ls,93,17825,21002,38827,841,15
kroA200.tsp,candidate-ls,55,20343,18598,38941,1442,15
kroB200.tsp,greedy-cycle,165,17075,19852,36927,2,15
kroA200.tsp,qc-ls,13,19540,20046,39586,873,15
kroB200.tsp,candidate-ls,3,19250,20314,39564,1393,15
kroA200.tsp,greedy-cycle,183,18068,17472,35540,2,15
kroB200.tsp,candidate-ls,145,18034,20303,38337,1507,15
kroB200.tsp,qc-ls,89,17913,20063,37976,947,15
kroB200.tsp,candidate-ls,25,20050,20711,40761,1406,15
kroB200.tsp,qc-ls,123,20584,18476,39060,789,15
kroB200.tsp,qc-ls,7,19517,20003,39520,817,15
kroA200.tsp,steepest-ls,173,19282,18878,38160,4688,15
kroA200.tsp,candidate-ls,79,19482,20333,39815,1403,15
kroA200.tsp,greedy-cycle,117,18187,17472,35659,2,15
kroA200.tsp,steepest-ls,49,20005,21301,41306,4931,15
kroA200.tsp,greedy-cycle,31,18374,17472,35846,2,15
kroA200.tsp,queue-ls,1,18867,19668,38535,838,15
kroA200.tsp,queue-ls,133,19349,20237,39586,841,15
kroB200.tsp,greedy-cycle,149,18449,21333,39782,2,15
kroB200.tsp,steepest-ls,25,19679,20200,39879,4983,15
kroB200.tsp,steepest-ls,197,19022,19315,38337,4801,15
kroA200.tsp,greedy-cycle,89,16943,20139,37082,2,15
kroB200.tsp,candidate-ls,169,18401,20228,38629,1508,15
kroB200.tsp,queue-ls,27,19347,20663,40010,860,15
kroB200.tsp,greedy-cycle,41,21106,17142,38248,4,15
kroA200.tsp,qc-ls,87,18503,19606,38109,852,15
kroA200.tsp,candidate-ls,137,17812,18892,36704,1566,15
kroA200.tsp,qc-ls,173,20006,18546,38552,851,15
kroB200.tsp,steepest-ls,181,19874,19805,39679,4972,15
kroB200.tsp,queue-ls,31,19159,18464,37623,842,15
kroA200.tsp,queue-ls,11,20301,19182,39483,843,15
kroA200.tsp,steepest-ls,149,19961,20018,39979,4856,15
kroA200.tsp,qc-ls,165,19897,18091,37988,902,15
kroA200.tsp,candidate-ls,121,19142,19292,38434,1654,15
kroA200.tsp,qc-ls,91,20320,20939,41259,812,15
kroB200.tsp,greedy-cycle,57,17191,21859,39050,4,15
kroB200.tsp,qc-ls,119,18866,18868,37734,849,15
kroB200.tsp,queue-ls,89,19546,20533,40079,804,15
kroA200.tsp,greedy-cycle,101,17861,22204,40065,3,15
kroA200.tsp,greedy-cycle,27,16872,20167,37039,2,15
kroB200.tsp,steepest-ls,139,21845,17520,39365,5313,15
kroB200.tsp,steepest-ls,33,19607,21204,40811,5013,15
kroA200.tsp,queue-ls,125,18711,20727,39438,835,15
kroA200.tsp,candidate-ls,199,18901,19611,38512,1416,15
kroA200.tsp,qc-ls,29,18222,19661,37883,889,15
