instance,solver,init_solver,neighbourhood,start_vertex,cost_first,cost_second,total_cost,duration
kroA100.tsp,greedy-ls,random-walk,N1,84,20812,18627,39439,399
kroA100.tsp,steepest-ls,random-walk,N2,73,16163,11609,27772,326
kroB100.tsp,steepest-ls,greedy-cycle,N1,38,11027,15534,26561,101
kroB100.tsp,greedy-ls,greedy-cycle,N2,15,14317,10353,24670,27
kroB100.tsp,steepest-ls,random-walk,N1,18,21631,20842,42473,576
kroA100.tsp,greedy-ls,random-walk,N2,94,14346,12569,26915,270
kroB100.tsp,steepest-ls,greedy-cycle,N2,28,11194,14354,25548,60
kroA100.tsp,steepest-ls,random-walk,N1,63,19136,17830,36966,410
kroB100.tsp,greedy-ls,greedy-cycle,N1,33,13785,10967,24752,253
kroA100.tsp,greedy-ls,greedy-cycle,N2,17,14428,11657,26085,28
kroA100.tsp,steepest-ls,random-walk,N2,24,15320,12348,27668,333
kroB100.tsp,greedy-ls,greedy-cycle,N1,52,12635,14757,27392,34
kroA100.tsp,greedy-ls,greedy-cycle,N1,50,11625,16077,27702,52
kroA100.tsp,steepest-ls,greedy-cycle,N2,49,15513,12386,27899,41
kroB100.tsp,steepest-ls,greedy-cycle,N1,80,11027,15534,26561,121
kroA100.tsp,steepest-ls,random-walk,N1,34,25124,14491,39615,613
kroB100.tsp,greedy-ls,greedy-cycle,N2,42,14317,10857,25174,16
kroA100.tsp,steepest-ls,greedy-cycle,N1,59,14595,11657,26252,36
kroA100.tsp,greedy-ls,greedy-cycle,N2,40,11481,14401,25882,41
kroA100.tsp,greedy-ls,greedy-cycle,N1,3,12386,15198,27584,22
kroB100.tsp,greedy-ls,greedy-cycle,N1,64,15011,10924,25935,161
kroB100.tsp,steepest-ls,greedy-cycle,N2,90,11506,14572,26078,255
kroB100.tsp,steepest-ls,random-walk,N2,49,15224,13104,28328,481
kroB100.tsp,greedy-ls,greedy-cycle,N1,44,14392,11444,25836,30
kroB100.tsp,steepest-ls,greedy-cycle,N1,79,11219,16084,27303,159
kroA100.tsp,steepest-ls,random-walk,N2,32,15406,10705,26111,312
kroB100.tsp,steepest-ls,greedy-cycle,N1,96,15985,11305,27290,62
kroA100.tsp,greedy-ls,greedy-cycle,N1,46,12386,15198,27584,31
kroB100.tsp,greedy-ls,greedy-cycle,N2,54,12420,14523,26943,27
kroB100.tsp,steepest-ls,random-walk,N1,59,18830,21504,40334,483
kroA100.tsp,steepest-ls,random-walk,N1,22,23906,20348,44254,494
kroB100.tsp,steepest-ls,greedy-cycle,N2,69,10344,13876,24220,63
kroB100.tsp,steepest-ls,greedy-cycle,N2,86,10838,15443,26281,200
kroB100.tsp,greedy-ls,greedy-cycle,N1,72,11316,17195,28511,191
kroA100.tsp,greedy-ls,greedy-cycle,N2,56,15198,12386,27584,32
kroA100.tsp,steepest-ls,random-walk,N2,65,16109,10176,26285,354
kroA100.tsp,greedy-ls,random-walk,N1,92,23506,13929,37435,884
kroB100.tsp,steepest-ls,random-walk,N1,7,22367,20955,43322,802
kroB100.tsp,greedy-ls,greedy-cycle,N1,13,14941,11792,26733,40
kroB100.tsp,greedy-ls,random-walk,N1,9,21006,23300,44306,554
kroA100.tsp,steepest-ls,random-walk,N1,5,23193,22379,45572,593
kroA100.tsp,greedy-ls,greedy-cycle,N1,11,14770,11657,26427,28
kroA100.tsp,steepest-ls,random-walk,N1,75,16953,20505,37458,374
kroA100.tsp,greedy-ls,random-walk,N2,82,15235,11844,27079,662
kroA100.tsp,steepest-ls,greedy-cycle,N1,18,14595,11657,26252,40
kroB100.tsp,greedy-ls,greedy-cycle,N1,25,10827,16739,27566,166
kroB100.tsp,greedy-ls,greedy-cycle,N1,87,12359,13865,26224,34
kroA100.tsp,steepest-ls,greedy-cycle,N2,73,11502,14991,26493,117
kroB100.tsp,steepest-ls,greedy-cycle,N1,55,15347,11907,27254,94
kroA100.tsp,greedy-ls,greedy-cycle,N1,85,11502,15434,26936,26
kroB100.tsp,greedy-ls,greedy-cycle,N1,68,11862,16557,28419,34
kroB100.tsp,greedy-ls,random-walk,N1,27,22227,19865,42092,649
kroB100.tsp,steepest-ls,random-walk,N2,65,15747,11432,27179,334
kroB100.tsp,greedy-ls,greedy-cycle,N2,97,11194,14532,25726,38
kroA100.tsp,steepest-ls,greedy-cycle,N1,63,14698,11657,26355,27
kroA100.tsp,greedy-ls,random-walk,N2,16,15186,11427,26613,195
kroB100.tsp,steepest-ls,greedy-cycle,N2,45,14882,10859,25741,87
kroA100.tsp,greedy-ls,greedy-cycle,N2,95,11657,14435,26092,16
kroB100.tsp,steepest-ls,random-walk,N1,75,22494,21854,44348,555
kroB100.tsp,greedy-ls,random-walk,N2,37,16956,14168,31124,258
kroB100.tsp,greedy-ls,greedy-cycle,N2,78,14883,11305,26188,139
kroA100.tsp,greedy-ls,random-walk,N1,51,20348,19292,39640,703
kroA100.tsp,steepest-ls,greedy-cycle,N2,24,14147,11657,25804,64
kroB100.tsp,greedy-ls,random-walk,N1,70,27297,17213,44510,211
kroB100.tsp,steepest-ls,random-walk,N2,32,14675,10836,25511,489
kroA100.tsp,steepest-ls,random-walk,N2,49,16386,10092,26478,298
kroB100.tsp,steepest-ls,random-walk,N2,2,16460,11758,28218,431
kroB100.tsp,greedy-ls,greedy-cycle,N1,1,12212,15826,28038,177
kroA100.tsp,greedy-ls,random-walk,N2,41,15438,11950,27388,1361
kroA100.tsp,steepest-ls,greedy-cycle,N1,34,11713,15934,27647,60
kroB100.tsp,steepest-ls,random-walk,N1,22,16824,19164,35988,478
kroB100.tsp,greedy-ls,random-walk,N2,60,15609,12879,28488,231
kroA100.tsp,steepest-ls,random-walk,N1,59,22725,24160,46885,350
kroB100.tsp,steepest-ls,greedy-cycle,N2,12,11194,14354,25548,69
kroB100.tsp,greedy-ls,random-walk,N1,89,25881,20127,46008,193
kroA100.tsp,steepest-ls,greedy-cycle,N2,32,14428,11657,26085,63
kroA100.tsp,greedy-ls,random-walk,N1,47,21785,17923,39708,614
kroB100.tsp,steepest-ls,greedy-cycle,N1,14,14899,10763,25662,120
kroB100.tsp,greedy-ls,greedy-cycle,N1,29,11194,15678,26872,20
kroB100.tsp,greedy-ls,random-walk,N1,66,19887,20907,40794,230
kroB100.tsp,steepest-ls,random-walk,N2,24,14865,11343,26208,284
kroB100.tsp,greedy-ls,random-walk,N2,99,15445,12666,28111,822
kroA100.tsp,steepest-ls,greedy-cycle,N1,22,15486,12386,27872,72
kroA100.tsp,greedy-ls,random-walk,N2,57,14888,12956,27844,224
kroB100.tsp,steepest-ls,random-walk,N1,34,21147,18821,39968,864
kroB100.tsp,greedy-ls,random-walk,N2,76,14831,13693,28524,255
kroB100.tsp,greedy-ls,greedy-cycle,N2,39,10153,16670,26823,24
kroA100.tsp,greedy-ls,random-walk,N1,10,19309,21347,40656,318
kroA100.tsp,steepest-ls,greedy-cycle,N2,65,15198,12386,27584,700
kroB100.tsp,greedy-ls,greedy-cycle,N1,91,11220,15678,26898,16
kroA100.tsp,greedy-ls,greedy-cycle,N2,6,15513,12386,27899,22
kroB100.tsp,greedy-ls,random-walk,N1,31,21088,18850,39938,242
kroB100.tsp,steepest-ls,random-walk,N2,73,16525,10163,26688,658
kroA100.tsp,greedy-ls,greedy-cycle,N1,93,12027,13870,25897,11
kroB100.tsp,steepest-ls,greedy-cycle,N1,43,12450,13865,26315,274
kroB100.tsp,greedy-ls,greedy-cycle,N1,48,14520,10555,25075,382
kroA100.tsp,steepest-ls,greedy-cycle,N1,75,15198,12386,27584,54
kroB100.tsp,greedy-ls,greedy-cycle,N2,81,11283,16850,28133,29
kroB100.tsp,steepest-ls,random-walk,N1,63,24486,25534,50020,864
kroB100.tsp,greedy-ls,random-walk,N2,21,16416,13386,29802,176
kroA100.tsp,greedy-ls,greedy-cycle,N2,83,11713,15281,26994,38
kroB100.tsp,steepest-ls,greedy-cycle,N2,53,10153,16651,26804,37
kroA100.tsp,steepest-ls,random-walk,N1,18,22732,17960,40692,487
kroB100.tsp,steepest-ls,greedy-cycle,N2,24,14384,11305,25689,56
kroA100.tsp,greedy-ls,random-walk,N2,98,15528,12920,28448,223
kroB100.tsp,steepest-ls,random-walk,N1,14,20858,24045,44903,694
kroB100.tsp,greedy-ls,random-walk,N2,56,15213,12996,28209,591
kroB100.tsp,greedy-ls,greedy-cycle,N2,19,14113,11222,25335,43
kroA100.tsp,greedy-ls,random-walk,N2,77,14602,12577,27179,189
kroB100.tsp,steepest-ls,greedy-cycle,N2,2,14317,10353,24670,81
kroA100.tsp,steepest-ls,random-walk,N1,80,20391,22084,42475,650
kroB100.tsp,steepest-ls,greedy-cycle,N1,34,10827,16739,27566,20
kroA100.tsp,greedy-ls,random-walk,N1,88,21943,17913,39856,238
kroB100.tsp,greedy-ls,random-walk,N1,46,20738,20009,40747,264
kroA100.tsp,steepest-ls,greedy-cycle,N2,12,11713,14957,26670,68
kroA100.tsp,greedy-ls,random-walk,N1,67,18774,19597,38371,218
kroA100.tsp,steepest-ls,random-walk,N2,90,15737,14968,30705,288
kroB100.tsp,steepest-ls,random-walk,N1,43,22022,24878,46900,541
kroB100.tsp,greedy-ls,greedy-cycle,N1,87,12440,14482,26922,383
kroB100.tsp,steepest-ls,greedy-cycle,N2,73,11108,13814,24922,60
kroA100.tsp,steepest-ls,random-walk,N1,38,19559,21116,40675,502
kroB100.tsp,greedy-ls,greedy-cycle,N1,68,12218,15252,27470,645
kroA100.tsp,greedy-ls,random-walk,N2,20,13808,12253,26061,206
kroA100.tsp,steepest-ls,greedy-cycle,N1,55,11713,15934,27647,50
kroB100.tsp,greedy-ls,random-walk,N1,11,21946,14937,36883,438
kroB100.tsp,steepest-ls,random-walk,N2,53,16881,12240,29121,379
kroA100.tsp,steepest-ls,greedy-cycle,N1,7,11713,15934,27647,76
kroA100.tsp,steepest-ls,random-walk,N2,28,16487,10287,26774,323
kroB100.tsp,steepest-ls,greedy-cycle,N1,63,14408,10577,24985,124
kroA100.tsp,greedy-ls,random-walk,N2,2,15892,12942,28834,215
kroB100.tsp,greedy-ls,greedy-cycle,N2,7,10837,15789,26626,17
kroA100.tsp,greedy-ls,random-walk,N1,30,19472,22743,42215,252
kroA100.tsp,steepest-ls,greedy-cycle,N2,45,14435,11657,26092,59
kroB100.tsp,steepest-ls,greedy-cycle,N2,65,11505,16324,27829,54
kroB100.tsp,greedy-ls,greedy-cycle,N1,91,11220,15678,26898,140
kroB100.tsp,steepest-ls,random-walk,N1,55,20966,10766,31732,543
kroB100.tsp,greedy-ls,random-walk,N2,17,16056,12355,28411,218
kroB100.tsp,greedy-ls,greedy-cycle,N2,58,10837,15562,26399,46
kroA100.tsp,steepest-ls,greedy-cycle,N1,43,12386,15198,27584,53
kroA100.tsp,greedy-ls,random-walk,N2,36,15043,13810,28853,353
kroB100.tsp,steepest-ls,greedy-cycle,N1,75,11027,15534,26561,155
kroB100.tsp,greedy-ls,greedy-cycle,N1,48,14407,11649,26056,27
kroB100.tsp,steepest-ls,random-walk,N2,45,15780,12114,27894,449
kroA100.tsp,steepest-ls,greedy-cycle,N2,53,15486,12386,27872,46
kroA100.tsp,greedy-ls,random-walk,N1,26,21257,17428,38685,510
kroB100.tsp,greedy-ls,random-walk,N2,40,15085,12500,27585,339
kroA100.tsp,steepest-ls,random-walk,N1,79,22633,20050,42683,466
kroB100.tsp,steepest-ls,greedy-cycle,N2,32,11194,14354,25548,77
kroA100.tsp,steepest-ls,random-walk,N1,96,23683,21630,45313,393
kroB100.tsp,greedy-ls,greedy-cycle,N1,29,11261,15678,26939,304
kroA100.tsp,greedy-ls,random-walk,N2,61,15032,13429,28461,316
kroA100.tsp,steepest-ls,greedy-cycle,N1,14,12386,15198,27584,76
kroB100.tsp,greedy-ls,random-walk,N1,50,22294,19755,42049,321
kroB100.tsp,steepest-ls,random-walk,N2,12,13900,13666,27566,465
kroB100.tsp,greedy-ls,random-walk,N1,5,18282,19876,38158,323
kroB100.tsp,greedy-ls,greedy-cycle,N2,100,10587,14785,25372,35
kroB100.tsp,steepest-ls,greedy-cycle,N1,22,15347,11907,27254,51
kroA100.tsp,steepest-ls,random-walk,N2,69,14154,11237,25391,343
kroA100.tsp,steepest-ls,random-walk,N2,86,13730,11745,25475,344
kroA100.tsp,greedy-ls,random-walk,N1,71,18624,17395,36019,405
kroA100.tsp,steepest-ls,random-walk,N1,9,22633,20724,43357,441
kroB100.tsp,greedy-ls,greedy-cycle,N1,52,12635,14798,27433,296
kroA100.tsp,greedy-ls,greedy-cycle,N2,76,11657,14435,26092,19
kroB100.tsp,steepest-ls,random-walk,N1,96,21243,15888,37131,544
kroB100.tsp,greedy-ls,greedy-cycle,N2,74,12541,13601,26142,56
kroB100.tsp,steepest-ls,random-walk,N1,79,25839,17600,43439,558
kroA100.tsp,steepest-ls,greedy-cycle,N1,80,11860,11668,23528,105
kroA100.tsp,greedy-ls,greedy-cycle,N2,99,14435,11657,26092,16
kroB100.tsp,steepest-ls,greedy-cycle,N2,49,10838,15443,26281,149
kroA100.tsp,greedy-ls,greedy-cycle,N1,66,15198,12386,27584,25
kroB100.tsp,steepest-ls,random-walk,N2,86,16227,13793,30020,397
kroB100.tsp,steepest-ls,random-walk,N2,69,14102,11649,25751,418
kroB100.tsp,greedy-ls,greedy-cycle,N1,64,14899,11113,26012,32
kroA100.tsp,greedy-ls,greedy-cycle,N1,89,13485,12074,25559,63
kroA100.tsp,steepest-ls,greedy-cycle,N2,90,15513,12386,27899,44
kroA100.tsp,greedy-ls,greedy-cycle,N2,100,12386,15198,27584,24
kroB100.tsp,steepest-ls,greedy-cycle,N1,59,11205,15678,26883,141
kroA100.tsp,steepest-ls,random-walk,N2,12,15383,10812,26195,322
kroB100.tsp,greedy-ls,random-walk,N2,83,17688,11712,29400,408
kroA100.tsp,greedy-ls,greedy-cycle,N2,21,14435,11657,26092,24
kroA100.tsp,steepest-ls,greedy-cycle,N1,38,14581,11657,26238,40
kroA100.tsp,steepest-ls,random-walk,N1,55,23016,17152,40168,447
kroB100.tsp,greedy-ls,greedy-cycle,N2,23,15254,11907,27161,28
kroB100.tsp,greedy-ls,random-walk,N1,93,23780,17889,41669,240
kroA100.tsp,steepest-ls,greedy-cycle,N2,28,13353,12498,25851,77
kroA100.tsp,greedy-ls,greedy-cycle,N1,31,11860,11668,23528,36
kroA100.tsp,steepest-ls,random-walk,N2,45,16818,14740,31558,314
kroB100.tsp,greedy-ls,greedy-cycle,N1,33,14317,11760,26077,32
kroB100.tsp,greedy-ls,greedy-cycle,N1,13,15054,11372,26426,122
kroA100.tsp,greedy-ls,greedy-cycle,N2,37,11502,14770,26272,28
kroB100.tsp,greedy-ls,random-walk,N2,95,15614,13925,29539,231
kroB100.tsp,greedy-ls,greedy-cycle,N2,35,10827,15707,26534,19
kroB100.tsp,steepest-ls,random-walk,N1,38,21855,23229,45084,748
kroA100.tsp,steepest-ls,random-walk,N1,43,25626,16360,41986,486
kroA100.tsp,greedy-ls,greedy-cycle,N1,27,11713,15934,27647,25
kroB100.tsp,greedy-ls,random-walk,N1,85,21850,18521,40371,189
kroB100.tsp,steepest-ls,random-walk,N2,28,15834,11464,27298,446
kroB100.tsp,greedy-ls,greedy-cycle,N1,25,10827,16739,27566,11
kroB100.tsp,steepest-ls,greedy-cycle,N1,7,10826,16765,27591,37
kroA100.tsp,steepest-ls,random-walk,N2,53,15603,10816,26419,478
kroB100.tsp,steepest-ls,greedy-cycle,N1,18,15576,11305,26881,49
kroB100.tsp,steepest-ls,random-walk,N1,80,26980,18921,45901,659
kroA100.tsp,steepest-ls,greedy-cycle,N1,79,15486,12386,27872,76
kroA100.tsp,steepest-ls,greedy-cycle,N2,2,11502,14991,26493,119
kroA100.tsp,greedy-ls,greedy-cycle,N2,60,11762,15533,27295,20
kroB100.tsp,greedy-ls,greedy-cycle,N1,44,15369,11444,26813,231
kroA100.tsp,steepest-ls,random-walk,N1,14,25802,14886,40688,413
kroA100.tsp,greedy-ls,random-walk,N1,7,26074,17779,43853,229
kroA100.tsp,steepest-ls,greedy-cycle,N1,96,11502,15434,26936,60
kroB100.tsp,greedy-ls,greedy-cycle,N2,62,10344,14008,24352,48
kroB100.tsp,greedy-ls,greedy-cycle,N1,2,15054,10617,25671,24
kroB100.tsp,steepest-ls,random-walk,N2,90,14995,12389,27384,392
kroA100.tsp,greedy-ls,greedy-cycle,N1,70,15486,12386,27872,33
kroA100.tsp,steepest-ls,greedy-cycle,N2,69,11502,14991,26493,118
kroA100.tsp,steepest-ls,greedy-cycle,N2,86,11713,14957,26670,92
kroB100.tsp,greedy-ls,greedy-cycle,N1,72,11449,17177,28626,22
kroB100.tsp,steepest-ls,random-walk,N2,91,15863,11793,27656,481
kroA100.tsp,steepest-ls,greedy-cycle,N2,68,11502,14424,25926,73
kroA100.tsp,greedy-ls,greedy-cycle,N1,71,12386,15198,27584,34
kroA100.tsp,steepest-ls,greedy-cycle,N2,87,11698,14957,26655,826
kroB100.tsp,greedy-ls,greedy-cycle,N1,73,11119,15138,26257,25
kroB100.tsp,steepest-ls,random-walk,N1,81,16305,20350,36655,613
kroA100.tsp,steepest-ls,greedy-cycle,N2,3,12386,15198,27584,64
kroA100.tsp,greedy-ls,greedy-cycle,N2,61,11698,15015,26713,22
kroA100.tsp,steepest-ls,greedy-cycle,N1,78,11502,15434,26936,67
kroB100.tsp,greedy-ls,greedy-cycle,N1,45,16703,10859,27562,241
kroA100.tsp,steepest-ls,random-walk,N1,15,22452,23923,46375,461
kroA100.tsp,greedy-ls,random-walk,N1,6,21533,17527,39060,840
kroA100.tsp,steepest-ls,greedy-cycle,N1,97,15198,12386,27584,61
kroB100.tsp,greedy-ls,greedy-cycle,N2,63,14204,10353,24557,56
kroB100.tsp,greedy-ls,greedy-cycle,N1,3,11108,15138,26246,24
kroA100.tsp,greedy-ls,greedy-cycle,N1,26,15198,12386,27584,24
kroB100.tsp,greedy-ls,random-walk,N1,84,21229,17921,39150,271
kroB100.tsp,steepest-ls,random-walk,N2,29,17096,12799,29895,374
kroB100.tsp,greedy-ls,greedy-cycle,N1,24,14434,11867,26301,32
kroB100.tsp,steepest-ls,greedy-cycle,N1,6,14317,10763,25080,143
kroA100.tsp,steepest-ls,random-walk,N2,52,14418,10222,24640,318
kroB100.tsp,steepest-ls,greedy-cycle,N1,19,15985,11305,27290,43
kroB100.tsp,greedy-ls,greedy-cycle,N1,12,11194,15678,26872,339
kroA100.tsp,greedy-ls,greedy-cycle,N2,36,14435,11657,26092,23
kroB100.tsp,greedy-ls,random-walk,N2,94,16018,13095,29113,281
kroB100.tsp,greedy-ls,greedy-cycle,N2,34,10827,15415,26242,33
kroB100.tsp,steepest-ls,random-walk,N1,39,19964,22033,41997,571
kroA100.tsp,steepest-ls,random-walk,N1,42,28415,20117,48532,461
kroB100.tsp,greedy-ls,random-walk,N1,92,18182,17224,35406,231
kroA100.tsp,greedy-ls,greedy-cycle,N1,30,12333,15086,27419,30
kroA100.tsp,steepest-ls,greedy-cycle,N2,29,12386,15198,27584,121
kroA100.tsp,steepest-ls,random-walk,N2,44,14975,10603,25578,307
kroB100.tsp,greedy-ls,greedy-cycle,N1,32,11220,15678,26898,16
kroB100.tsp,greedy-ls,random-walk,N2,82,16335,11276,27611,689
kroA100.tsp,steepest-ls,greedy-cycle,N1,39,12333,15083,27416,61
kroA100.tsp,greedy-ls,greedy-cycle,N2,20,11429,14066,25495,41
kroB100.tsp,greedy-ls,random-walk,N2,1,16900,11214,28114,232
kroA100.tsp,steepest-ls,random-walk,N1,54,24847,24648,49495,353
kroB100.tsp,greedy-ls,greedy-cycle,N2,22,15144,11907,27051,30
kroA100.tsp,greedy-ls,greedy-cycle,N1,67,13148,12828,25976,34
kroB100.tsp,steepest-ls,random-walk,N2,87,16612,12835,29447,620
kroB100.tsp,steepest-ls,random-walk,N2,68,14002,12022,26024,783
kroB100.tsp,greedy-ls,greedy-cycle,N1,65,11493,16694,28187,32
kroA100.tsp,steepest-ls,greedy-cycle,N2,91,14435,11657,26092,52
kroA100.tsp,greedy-ls,greedy-cycle,N1,88,15486,12386,27872,24
kroB100.tsp,greedy-ls,random-walk,N2,100,18025,14810,32835,938
kroB100.tsp,steepest-ls,greedy-cycle,N1,58,10826,16765,27591,30
kroA100.tsp,steepest-ls,random-walk,N2,13,16072,13099,29171,322
kroB100.tsp,greedy-ls,greedy-cycle,N1,53,10342,16742,27084,218
kroA100.tsp,greedy-ls,greedy-cycle,N2,77,11762,15533,27295,28
kroB100.tsp,steepest-ls,random-walk,N1,97,22763,17920,40683,447
kroB100.tsp,greedy-ls,greedy-cycle,N2,75,11103,15324,26427,34
kroB100.tsp,steepest-ls,random-walk,N1,78,17383,18768,36151,508
kroA100.tsp,greedy-ls,greedy-cycle,N2,98,14157,11657,25814,32
kroA100.tsp,steepest-ls,greedy-cycle,N1,81,11698,16222,27920,86
kroB100.tsp,steepest-ls,greedy-cycle,N2,48,14317,10353,24670,152
kroB100.tsp,greedy-ls,random-walk,N1,4,23129,19954,43083,740
kroB100.tsp,greedy-ls,random-walk,N1,51,22064,16351,38415,256
kroB100.tsp,steepest-ls,random-walk,N2,13,15400,12156,27556,278
kroB100.tsp,steepest-ls,greedy-cycle,N1,23,15347,11907,27254,87
kroA100.tsp,steepest-ls,random-walk,N2,68,15777,11289,27066,335
kroA100.tsp,steepest-ls,random-walk,N2,87,16251,11841,28092,467
kroA100.tsp,greedy-ls,random-walk,N1,70,18980,14333,33313,395
kroA100.tsp,steepest-ls,random-walk,N1,8,21018,15288,36306,820
kroB100.tsp,greedy-ls,random-walk,N2,41,14526,12176,26702,184
kroA100.tsp,steepest-ls,random-walk,N1,78,24271,20856,45127,423
kroB100.tsp,steepest-ls,greedy-cycle,N2,33,14317,10353,24670,57
kroA100.tsp,steepest-ls,random-walk,N1,97,21815,16953,38768,465
kroB100.tsp,greedy-ls,greedy-cycle,N1,28,11220,15678,26898,260
kroA100.tsp,greedy-ls,random-walk,N2,60,15615,10276,25891,555
kroA100.tsp,steepest-ls,greedy-cycle,N1,15,14770,11657,26427,44
kroB100.tsp,steepest-ls,greedy-cycle,N1,74,12450,13865,26315,266
kroB100.tsp,greedy-ls,greedy-cycle,N1,49,11250,15302,26552,51
kroB100.tsp,steepest-ls,random-walk,N2,44,17106,11958,29064,640
kroA100.tsp,steepest-ls,greedy-cycle,N2,52,11502,14424,25926,62
kroA100.tsp,greedy-ls,random-walk,N1,27,25450,19886,45336,222
kroB100.tsp,steepest-ls,greedy-cycle,N2,64,14017,10353,24370,101
kroB100.tsp,greedy-ls,greedy-cycle,N1,90,12212,15826,28038,378
kroB100.tsp,steepest-ls,random-walk,N1,54,23241,17296,40537,600
kroB100.tsp,greedy-ls,random-walk,N2,16,15385,12607,27992,347
kroB100.tsp,greedy-ls,greedy-cycle,N2,59,11194,14653,25847,33
kroA100.tsp,steepest-ls,greedy-cycle,N1,42,11860,11668,23528,93
kroA100.tsp,greedy-ls,random-walk,N2,37,16922,13869,30791,216
kroB100.tsp,greedy-ls,random-walk,N1,10,25017,21389,46406,243
kroB100.tsp,steepest-ls,random-walk,N2,52,14868,12262,27130,331
kroA100.tsp,steepest-ls,greedy-cycle,N1,6,15513,12386,27899,60
kroA100.tsp,steepest-ls,random-walk,N2,29,13624,12647,26271,311
kroB100.tsp,steepest-ls,greedy-cycle,N1,62,10730,14227,24957,110
kroA100.tsp,greedy-ls,random-walk,N2,3,15471,13204,28675,311
kroA100.tsp,greedy-ls,random-walk,N1,31,23160,18271,41431,530
kroB100.tsp,greedy-ls,greedy-cycle,N2,6,14204,10796,25000,33
kroA100.tsp,steepest-ls,greedy-cycle,N2,44,11502,14991,26493,106
kroB100.tsp,steepest-ls,random-walk,N1,42,26630,17973,44603,1623
kroB100.tsp,greedy-ls,greedy-cycle,N1,86,11191,15282,26473,275
kroB100.tsp,steepest-ls,greedy-cycle,N2,72,10628,17104,27732,66
kroA100.tsp,steepest-ls,random-walk,N1,39,20971,19075,40046,472
kroB100.tsp,greedy-ls,greedy-cycle,N1,69,10565,15349,25914,323
kroA100.tsp,greedy-ls,random-walk,N2,21,16588,13353,29941,230
kroA100.tsp,steepest-ls,greedy-cycle,N1,54,11600,14330,25930,74
kroB100.tsp,steepest-ls,greedy-cycle,N1,35,10827,16739,27566,18
kroA100.tsp,greedy-ls,random-walk,N1,89,19350,17155,36505,344
kroB100.tsp,greedy-ls,random-walk,N1,47,25157,19910,45067,304
kroA100.tsp,steepest-ls,greedy-cycle,N2,13,11657,14435,26092,47
kroA100.tsp,greedy-ls,random-walk,N1,66,23198,19683,42881,304
kroA100.tsp,steepest-ls,random-walk,N2,91,14583,12392,26975,365
kroB100.tsp,steepest-ls,greedy-cycle,N2,25,10827,15415,26242,46
kroA100.tsp,greedy-ls,random-walk,N2,99,14534,12503,27037,313
kroB100.tsp,steepest-ls,random-walk,N1,15,20968,19145,40113,561
kroB100.tsp,greedy-ls,random-walk,N2,57,16242,10799,27041,476
kroB100.tsp,greedy-ls,greedy-cycle,N2,18,14525,11867,26392,27
kroB100.tsp,steepest-ls,greedy-cycle,N2,3,11108,13814,24922,62
kroA100.tsp,greedy-ls,random-walk,N2,76,15546,11831,27377,195
kroA100.tsp,steepest-ls,random-walk,N1,81,24842,19137,43979,876
kroB100.tsp,greedy-ls,greedy-cycle,N1,49,11250,15415,26665,571
kroA100.tsp,steepest-ls,greedy-cycle,N1,74,14595,11657,26252,46
kroB100.tsp,greedy-ls,greedy-cycle,N2,80,10851,15214,26065,41
kroB100.tsp,steepest-ls,random-walk,N1,62,20097,22253,42350,1398
kroB100.tsp,greedy-ls,random-walk,N2,20,15404,13783,29187,217
kroA100.tsp,greedy-ls,greedy-cycle,N2,82,11657,14435,26092,29
kroB100.tsp,steepest-ls,greedy-cycle,N2,52,12420,14523,26943,76
kroA100.tsp,steepest-ls,random-walk,N1,19,24536,16706,41242,630
kroA100.tsp,greedy-ls,random-walk,N1,11,23680,14299,37979,487
kroA100.tsp,steepest-ls,greedy-cycle,N2,64,11502,14991,26493,204
kroB100.tsp,greedy-ls,greedy-cycle,N1,90,12212,15896,28108,44
kroB100.tsp,greedy-ls,random-walk,N1,30,20627,13542,34169,266
kroB100.tsp,steepest-ls,random-walk,N2,72,16173,13739,29912,468
kroA100.tsp,greedy-ls,greedy-cycle,N2,7,11669,15500,27169,20
kroA100.tsp,greedy-ls,greedy-cycle,N1,92,11860,11693,23553,48
kroB100.tsp,steepest-ls,greedy-cycle,N1,42,14408,10577,24985,272
kroB100.tsp,greedy-ls,random-walk,N2,98,15020,13423,28443,770
kroA100.tsp,steepest-ls,greedy-cycle,N1,23,14770,11657,26427,55
kroA100.tsp,greedy-ls,random-walk,N2,56,14813,12617,27430,222
kroB100.tsp,steepest-ls,random-walk,N1,35,18365,16457,34822,835
kroB100.tsp,greedy-ls,random-walk,N2,77,14901,13979,28880,235
kroB100.tsp,greedy-ls,greedy-cycle,N2,38,10693,15594,26287,38
kroB100.tsp,greedy-ls,random-walk,N1,88,18150,21087,39237,272
kroA100.tsp,steepest-ls,greedy-cycle,N2,33,11657,14435,26092,56
kroA100.tsp,greedy-ls,random-walk,N1,46,21771,19881,41652,1001
kroB100.tsp,steepest-ls,greedy-cycle,N1,15,14317,10763,25080,67
kroB100.tsp,greedy-ls,greedy-cycle,N1,28,11194,15678,26872,18
kroB100.tsp,greedy-ls,random-walk,N1,67,26763,18180,44943,196
kroB100.tsp,steepest-ls,random-walk,N2,25,15356,12114,27470,370
kroB100.tsp,steepest-ls,random-walk,N2,3,16009,12637,28646,289
kroA100.tsp,greedy-ls,random-walk,N2,40,15685,12032,27717,1194
kroA100.tsp,steepest-ls,greedy-cycle,N1,35,11713,15934,27647,68
kroB100.tsp,steepest-ls,random-walk,N1,23,18853,18832,37685,452
kroB100.tsp,greedy-ls,random-walk,N2,61,14935,11283,26218,432
kroA100.tsp,steepest-ls,random-walk,N2,1,14208,10713,24921,385
kroA100.tsp,steepest-ls,random-walk,N1,58,22362,16622,38984,356
kroB100.tsp,steepest-ls,greedy-cycle,N2,13,14317,10353,24670,52
kroA100.tsp,greedy-ls,random-walk,N1,50,21035,21245,42280,345
kroA100.tsp,steepest-ls,greedy-cycle,N2,25,11698,15245,26943,206
kroB100.tsp,greedy-ls,random-walk,N1,71,23074,15988,39062,215
kroB100.tsp,steepest-ls,random-walk,N2,33,16811,10104,26915,535
kroA100.tsp,steepest-ls,random-walk,N2,48,15446,13147,28593,291
kroB100.tsp,greedy-ls,greedy-cycle,N2,96,14540,11305,25845,44
kroA100.tsp,steepest-ls,greedy-cycle,N1,62,11915,15550,27465,38
kroA100.tsp,greedy-ls,random-walk,N2,17,15466,12995,28461,224
kroB100.tsp,steepest-ls,greedy-cycle,N2,44,14060,11444,25504,48
kroA100.tsp,greedy-ls,greedy-cycle,N2,94,15513,12386,27899,22
kroB100.tsp,steepest-ls,random-walk,N1,74,20111,20799,40910,573
kroB100.tsp,greedy-ls,random-walk,N2,36,16558,13020,29578,257
kroB100.tsp,greedy-ls,greedy-cycle,N2,79,11256,16793,28049,34
kroB100.tsp,greedy-ls,greedy-cycle,N1,86,11250,15415,26665,34
kroA100.tsp,steepest-ls,greedy-cycle,N2,72,14435,11657,26092,56
kroB100.tsp,steepest-ls,greedy-cycle,N1,54,12635,14757,27392,104
kroA100.tsp,greedy-ls,greedy-cycle,N1,84,14581,11657,26238,15
kroB100.tsp,greedy-ls,greedy-cycle,N1,69,11087,13866,24953,49
kroB100.tsp,greedy-ls,random-walk,N1,26,27005,19430,46435,300
kroB100.tsp,steepest-ls,random-walk,N2,64,17343,9775,27118,441
kroA100.tsp,steepest-ls,random-walk,N1,74,27194,19215,46409,369
kroA100.tsp,greedy-ls,random-walk,N2,83,15371,12446,27817,252
kroA100.tsp,steepest-ls,greedy-cycle,N1,19,15198,12386,27584,75
kroB100.tsp,greedy-ls,greedy-cycle,N1,24,14864,11305,26169,1040
kroA100.tsp,steepest-ls,random-walk,N2,64,16634,14908,31542,299
kroA100.tsp,greedy-ls,random-walk,N1,93,24756,14277,39033,998
kroB100.tsp,steepest-ls,random-walk,N1,6,24174,18496,42670,855
kroB100.tsp,greedy-ls,greedy-cycle,N1,12,11194,15678,26872,19
kroB100.tsp,greedy-ls,random-walk,N1,8,19118,17774,36892,285
kroA100.tsp,steepest-ls,random-walk,N1,4,26387,19283,45670,731
kroA100.tsp,greedy-ls,greedy-cycle,N1,10,14595,11657,26252,25
kroB100.tsp,greedy-ls,greedy-cycle,N2,55,15141,11733,26874,148
kroB100.tsp,steepest-ls,random-walk,N1,58,20983,23441,44424,426
kroA100.tsp,steepest-ls,random-walk,N1,23,20333,21528,41861,750
kroB100.tsp,steepest-ls,greedy-cycle,N2,68,10896,15873,26769,58
kroB100.tsp,steepest-ls,greedy-cycle,N2,87,12450,13601,26051,86
kroB100.tsp,greedy-ls,greedy-cycle,N1,73,11119,15138,26257,418
kroA100.tsp,greedy-ls,greedy-cycle,N2,57,11713,15229,26942,41
kroB100.tsp,steepest-ls,random-walk,N2,48,15291,13959,29250,311
kroB100.tsp,greedy-ls,greedy-cycle,N1,45,16479,10859,27338,29
kroB100.tsp,steepest-ls,greedy-cycle,N1,78,15576,11305,26881,66
kroA100.tsp,steepest-ls,random-walk,N2,33,14855,13186,28041,345
kroB100.tsp,steepest-ls,greedy-cycle,N1,97,11205,15678,26883,61
kroA100.tsp,greedy-ls,greedy-cycle,N1,47,14995,11657,26652,26
kroA100.tsp,steepest-ls,random-walk,N1,35,21061,25019,46080,2137
kroB100.tsp,greedy-ls,greedy-cycle,N2,43,12359,13862,26221,44
kroA100.tsp,greedy-ls,greedy-cycle,N2,41,12386,15198,27584,28
kroA100.tsp,steepest-ls,greedy-cycle,N1,58,11480,15146,26626,80
kroA100.tsp,greedy-ls,greedy-cycle,N1,2,11502,15202,26704,36
kroB100.tsp,greedy-ls,greedy-cycle,N1,65,11666,16493,28159,343
kroB100.tsp,steepest-ls,greedy-cycle,N2,91,11194,14354,25548,103
kroA100.tsp,steepest-ls,random-walk,N2,25,15314,12340,27654,395
kroB100.tsp,greedy-ls,greedy-cycle,N1,53,10629,16742,27371,19
kroA100.tsp,steepest-ls,greedy-cycle,N2,48,12386,15198,27584,57
kroA100.tsp,greedy-ls,greedy-cycle,N1,51,11698,15934,27632,26
kroB100.tsp,steepest-ls,greedy-cycle,N1,81,11219,16084,27303,149
kroB100.tsp,greedy-ls,greedy-cycle,N2,14,14546,10477,25023,30
kroB100.tsp,steepest-ls,random-walk,N1,19,23862,18715,42577,497
kroA100.tsp,greedy-ls,random-walk,N2,95,16300,12471,28771,229
kroB100.tsp,steepest-ls,greedy-cycle,N2,29,11194,14354,25548,61
kroA100.tsp,steepest-ls,random-walk,N1,62,26524,25957,52481,569
kroB100.tsp,greedy-ls,greedy-cycle,N1,32,11194,15678,26872,461
kroA100.tsp,greedy-ls,greedy-cycle,N2,16,15513,12386,27899,19
kroA100.tsp,greedy-ls,random-walk,N1,85,23002,20611,43613,324
kroA100.tsp,steepest-ls,random-walk,N2,72,13980,11452,25432,315
kroB100.tsp,steepest-ls,greedy-cycle,N1,39,10342,16742,27084,114
kroB100.tsp,steepest-ls,random-walk,N1,12,19819,18826,38645,557
kroB100.tsp,greedy-ls,random-walk,N2,50,15977,10845,26822,185
kroB100.tsp,steepest-ls,greedy-cycle,N2,22,14968,11907,26875,51
kroA100.tsp,steepest-ls,random-walk,N1,69,21213,14463,35676,388
kroB100.tsp,greedy-ls,greedy-cycle,N1,39,10342,16742,27084,198
kroA100.tsp,greedy-ls,random-walk,N2,71,13499,13564,27063,227
kroB100.tsp,steepest-ls,greedy-cycle,N2,4,14317,10353,24670,78
kroA100.tsp,steepest-ls,random-walk,N1,86,24166,16104,40270,384
kroB100.tsp,greedy-ls,random-walk,N1,40,19307,17702,37009,290
kroA100.tsp,steepest-ls,random-walk,N2,79,13831,11697,25528,303
kroB100.tsp,steepest-ls,greedy-cycle,N1,32,11205,15678,26883,39
kroA100.tsp,greedy-ls,random-walk,N1,61,27132,17099,44231,247
kroA100.tsp,steepest-ls,random-walk,N2,96,14518,13373,27891,299
kroA100.tsp,steepest-ls,greedy-cycle,N2,14,12386,15198,27584,72
kroB100.tsp,greedy-ls,greedy-cycle,N1,81,11533,16511,28044,386
kroB100.tsp,steepest-ls,greedy-cycle,N2,75,10838,15443,26281,133
kroB100.tsp,steepest-ls,random-walk,N1,45,23158,17204,40362,846
kroB100.tsp,greedy-ls,greedy-cycle,N2,48,14336,10357,24693,51
kroA100.tsp,steepest-ls,greedy-cycle,N1,53,15486,12386,27872,48
kroA100.tsp,greedy-ls,random-walk,N2,26,14401,12085,26486,237
kroA100.tsp,greedy-ls,greedy-cycle,N1,9,11845,15967,27812,23
kroB100.tsp,steepest-ls,greedy-cycle,N1,65,11219,16084,27303,80
kroA100.tsp,steepest-ls,greedy-cycle,N1,1,12532,11649,24181,95
kroB100.tsp,greedy-ls,greedy-cycle,N1,58,10837,16765,27602,20
kroB100.tsp,greedy-ls,random-walk,N1,17,20587,23267,43854,321
kroB100.tsp,steepest-ls,random-walk,N2,55,15186,11702,26888,1298
kroB100.tsp,steepest-ls,random-walk,N2,100,15949,13094,29043,380
kroA100.tsp,steepest-ls,greedy-cycle,N2,43,12386,15198,27584,67
kroA100.tsp,greedy-ls,random-walk,N2,4,16055,12693,28748,230
kroB100.tsp,greedy-ls,greedy-cycle,N2,1,12068,15309,27377,27
kroA100.tsp,greedy-ls,random-walk,N1,36,25250,21943,47193,231
kroB100.tsp,steepest-ls,random-walk,N1,53,26089,14493,40582,399
kroB100.tsp,greedy-ls,random-walk,N2,11,18264,10590,28854,203
kroA100.tsp,steepest-ls,random-walk,N1,28,23428,14026,37454,476
kroB100.tsp,steepest-ls,greedy-cycle,N2,63,14317,10353,24670,81
kroB100.tsp,greedy-ls,greedy-cycle,N1,97,11194,15678,26872,210
kroB100.tsp,greedy-ls,greedy-cycle,N1,78,14993,11305,26298,388
kroA100.tsp,greedy-ls,random-walk,N2,30,16730,13461,30191,306
kroA100.tsp,steepest-ls,greedy-cycle,N1,45,14770,11657,26427,37
kroB100.tsp,steepest-ls,random-walk,N2,43,15530,12058,27588,396
kroB100.tsp,steepest-ls,greedy-cycle,N1,73,11119,15138,26257,44
kroA100.tsp,steepest-ls,random-walk,N2,38,18348,12443,30791,345
kroA100.tsp,greedy-ls,random-walk,N1,20,22414,20388,42802,283
kroA100.tsp,steepest-ls,greedy-cycle,N2,55,11713,14957,26670,151
kroA100.tsp,greedy-ls,random-walk,N2,88,14081,11664,25745,256
kroB100.tsp,steepest-ls,greedy-cycle,N2,34,10827,15415,26242,46
kroB100.tsp,greedy-ls,random-walk,N2,46,15392,13784,29176,280
kroA100.tsp,steepest-ls,greedy-cycle,N1,12,11713,15934,27647,56
kroA100.tsp,steepest-ls,random-walk,N1,90,22255,20155,42410,498
kroA100.tsp,greedy-ls,random-walk,N2,67,14431,14089,28520,208
kroA100.tsp,greedy-ls,random-walk,N1,98,17290,16984,34274,328
kroB100.tsp,steepest-ls,greedy-cycle,N1,24,15576,11305,26881,212
kroB100.tsp,greedy-ls,greedy-cycle,N1,19,15000,11305,26305,30
kroB100.tsp,greedy-ls,random-walk,N1,56,23833,16303,40136,235
kroB100.tsp,steepest-ls,random-walk,N2,14,15053,13523,28576,540
kroB100.tsp,steepest-ls,greedy-cycle,N2,100,10344,13876,24220,96
kroB100.tsp,greedy-ls,random-walk,N1,3,21055,18117,39172,911
kroA100.tsp,steepest-ls,random-walk,N2,80,15546,10189,25735,318
kroA100.tsp,greedy-ls,random-walk,N1,77,21093,19307,40400,616
kroA100.tsp,greedy-ls,greedy-cycle,N2,70,15486,12386,27872,25
kroA100.tsp,steepest-ls,greedy-cycle,N1,69,11600,14330,25930,69
kroB100.tsp,steepest-ls,random-walk,N1,90,18925,20657,39582,642
kroB100.tsp,greedy-ls,greedy-cycle,N1,54,12635,14757,27392,217
kroB100.tsp,greedy-ls,greedy-cycle,N2,72,10643,16884,27527,60
kroA100.tsp,steepest-ls,greedy-cycle,N1,86,11713,15934,27647,52
kroA100.tsp,steepest-ls,greedy-cycle,N2,79,15486,12386,27872,83
kroA100.tsp,greedy-ls,greedy-cycle,N1,60,11771,16016,27787,24
kroB100.tsp,steepest-ls,random-walk,N2,80,16641,11598,28239,451
kroA100.tsp,steepest-ls,random-walk,N2,14,16257,11867,28124,366
kroB100.tsp,greedy-ls,greedy-cycle,N1,62,10541,13854,24395,36
kroA100.tsp,steepest-ls,greedy-cycle,N2,96,11502,14424,25926,86
kroB100.tsp,greedy-ls,random-walk,N2,6,15460,14406,29866,202
kroB100.tsp,steepest-ls,random-walk,N2,8,15215,13815,29030,586
kroB100.tsp,greedy-ls,random-walk,N2,85,16305,11939,28244,209
kroA100.tsp,greedy-ls,greedy-cycle,N2,27,11713,15542,27255,25
kroB100.tsp,greedy-ls,greedy-cycle,N2,25,10827,15593,26420,29
kroB100.tsp,steepest-ls,random-walk,N1,28,23465,15489,38954,628
kroA100.tsp,steepest-ls,random-walk,N1,53,22968,23212,46180,403
kroB100.tsp,steepest-ls,greedy-cycle,N2,18,14384,11305,25689,49
kroB100.tsp,greedy-ls,random-walk,N1,95,24440,15872,40312,233
kroA100.tsp,greedy-ls,greedy-cycle,N1,37,11502,15437,26939,29
kroB100.tsp,steepest-ls,random-walk,N2,38,15939,12639,28578,506
kroB100.tsp,greedy-ls,greedy-cycle,N1,35,10827,16739,27566,13
kroA100.tsp,steepest-ls,random-walk,N2,43,16265,11790,28055,289
kroA100.tsp,steepest-ls,greedy-cycle,N1,28,13148,12828,25976,122
kroA100.tsp,greedy-ls,greedy-cycle,N2,31,11959,11629,23588,55
kroB100.tsp,greedy-ls,random-walk,N2,93,15987,10763,26750,256
kroB100.tsp,greedy-ls,greedy-cycle,N1,15,14317,10617,24934,261
kroA100.tsp,steepest-ls,random-walk,N1,45,22460,22658,45118,717
kroB100.tsp,greedy-ls,greedy-cycle,N2,33,14317,10353,24670,28
kroA100.tsp,greedy-ls,greedy-cycle,N1,21,14581,11657,26238,27
kroA100.tsp,steepest-ls,greedy-cycle,N2,38,14435,11657,26092,42
kroB100.tsp,greedy-ls,random-walk,N1,83,21879,16621,38500,223
kroA100.tsp,steepest-ls,random-walk,N2,55,15238,12317,27555,305
kroB100.tsp,greedy-ls,greedy-cycle,N1,23,15267,11907,27174,30
kroB100.tsp,steepest-ls,greedy-cycle,N1,1,12212,15896,28108,122
kroB100.tsp,greedy-ls,greedy-cycle,N1,42,14408,10982,25390,411
kroB100.tsp,steepest-ls,random-walk,N1,86,24926,18606,43532,686
kroA100.tsp,steepest-ls,greedy-cycle,N2,4,15198,12386,27584,64
kroA100.tsp,greedy-ls,greedy-cycle,N2,66,15198,12386,27584,58
kroA100.tsp,greedy-ls,greedy-cycle,N2,89,11860,11011,22871,69
kroA100.tsp,steepest-ls,greedy-cycle,N1,90,15513,12386,27899,61
kroA100.tsp,greedy-ls,random-walk,N1,1,23390,16915,40305,1572
kroB100.tsp,greedy-ls,greedy-cycle,N1,4,14317,10954,25271,25
kroB100.tsp,greedy-ls,greedy-cycle,N2,64,14338,10331,24669,49
kroB100.tsp,steepest-ls,random-walk,N1,69,22244,17453,39697,484
kroB100.tsp,steepest-ls,greedy-cycle,N2,59,11194,14354,25548,116
kroA100.tsp,steepest-ls,random-walk,N1,12,20699,18533,39232,471
kroB100.tsp,steepest-ls,random-walk,N2,96,14915,13459,28374,461
kroA100.tsp,greedy-ls,greedy-cycle,N1,76,11657,14581,26238,21
kroA100.tsp,steepest-ls,greedy-cycle,N2,80,11860,10969,22829,162
kroA100.tsp,greedy-ls,greedy-cycle,N1,99,14581,11657,26238,20
kroB100.tsp,steepest-ls,random-walk,N2,79,14474,11331,25805,419
kroB100.tsp,greedy-ls,greedy-cycle,N1,74,12268,13868,26136,34
kroB100.tsp,steepest-ls,greedy-cycle,N1,49,11027,15534,26561,104
kroA100.tsp,greedy-ls,random-walk,N1,82,20750,25181,45931,287
kroA100.tsp,steepest-ls,random-walk,N2,75,14201,12817,27018,353
kroA100.tsp,steepest-ls,greedy-cycle,N2,18,14147,11657,25804,85
kroA100.tsp,greedy-ls,random-walk,N2,92,14367,10255,24622,218
kroA100.tsp,steepest-ls,random-walk,N1,65,25969,18355,44324,509
kroB100.tsp,greedy-ls,greedy-cycle,N2,13,14317,10353,24670,32
kroA100.tsp,greedy-ls,greedy-cycle,N2,11,14435,11657,26092,20
kroB100.tsp,steepest-ls,greedy-cycle,N2,8,11194,14354,25548,68
kroB100.tsp,greedy-ls,greedy-cycle,N1,35,10827,16739,27566,127
kroB100.tsp,steepest-ls,random-walk,N2,59,13785,11676,25461,403
kroB100.tsp,greedy-ls,greedy-cycle,N1,54,12635,14757,27392,33
kroA100.tsp,steepest-ls,random-walk,N2,22,15640,11805,27445,329
kroB100.tsp,steepest-ls,greedy-cycle,N1,69,10730,14227,24957,215
kroB100.tsp,steepest-ls,greedy-cycle,N1,86,11027,15534,26561,164
kroA100.tsp,greedy-ls,random-walk,N2,8,16411,10693,27104,219
kroA100.tsp,greedy-ls,greedy-cycle,N1,56,15198,12386,27584,27
kroB100.tsp,greedy-ls,greedy-cycle,N2,44,14108,11444,25552,26
kroB100.tsp,steepest-ls,random-walk,N1,49,22532,21788,44320,496
kroB100.tsp,steepest-ls,greedy-cycle,N2,79,11505,16324,27829,114
kroA100.tsp,steepest-ls,random-walk,N1,32,23145,17651,40796,822
kroA100.tsp,greedy-ls,greedy-cycle,N1,5,11502,15437,26939,25
kroB100.tsp,greedy-ls,greedy-cycle,N1,62,11010,15938,26948,554
kroB100.tsp,steepest-ls,greedy-cycle,N2,96,14206,11305,25511,88
kroA100.tsp,greedy-ls,greedy-cycle,N2,46,12386,15198,27584,18
kroA100.tsp,steepest-ls,random-walk,N2,34,13999,10920,24919,339
kroB100.tsp,greedy-ls,greedy-cycle,N1,42,14295,10617,24912,53
kroA100.tsp,steepest-ls,greedy-cycle,N2,59,14147,11657,25804,81
kroA100.tsp,greedy-ls,greedy-cycle,N1,40,11600,14330,25930,44
kroB100.tsp,steepest-ls,greedy-cycle,N1,90,12212,15896,28108,61
kroA100.tsp,steepest-ls,random-walk,N1,24,24772,21790,46562,497
kroB100.tsp,greedy-ls,greedy-cycle,N2,52,12537,14523,27060,21
kroA100.tsp,greedy-ls,greedy-cycle,N2,50,11600,14076,25676,37
kroA100.tsp,steepest-ls,greedy-cycle,N1,49,15513,12386,27899,44
kroB100.tsp,steepest-ls,greedy-cycle,N2,80,10838,15443,26281,151
kroB100.tsp,greedy-ls,greedy-cycle,N1,74,12450,13678,26128,656
kroB100.tsp,steepest-ls,random-walk,N1,1,23969,21236,45205,808
kroB100.tsp,steepest-ls,random-walk,N2,18,15263,12813,28076,737
kroB100.tsp,greedy-ls,greedy-cycle,N1,15,14429,10741,25170,24
kroB100.tsp,steepest-ls,greedy-cycle,N1,28,11205,15678,26883,61
kroA100.tsp,steepest-ls,random-walk,N2,63,15249,12145,27394,276
kroA100.tsp,greedy-ls,random-walk,N1,94,24220,16009,40229,696
kroA100.tsp,steepest-ls,random-walk,N1,3,18626,22743,41369,1381
kroA100.tsp,greedy-ls,greedy-cycle,N1,17,14763,11657,26420,22
kroA100.tsp,steepest-ls,random-walk,N1,73,21556,21248,42804,446
kroB100.tsp,steepest-ls,greedy-cycle,N2,38,10838,15443,26281,70
kroA100.tsp,greedy-ls,random-walk,N2,84,15596,12776,28372,265
kroB100.tsp,greedy-ls,greedy-cycle,N1,23,15301,11907,27208,308
kroB100.tsp,greedy-ls,greedy-cycle,N1,81,11478,16714,28192,34
kroA100.tsp,steepest-ls,greedy-cycle,N2,75,15198,12386,27584,61
kroA100.tsp,greedy-ls,greedy-cycle,N1,83,11713,15934,27647,25
kroB100.tsp,greedy-ls,random-walk,N1,21,27631,18810,46441,291
kroB100.tsp,steepest-ls,random-walk,N2,63,17548,14206,31754,433
kroB100.tsp,steepest-ls,greedy-cycle,N1,53,10342,16742,27084,45
kroA100.tsp,steepest-ls,random-walk,N2,18,16980,10637,27617,309
kroA100.tsp,greedy-ls,random-walk,N1,100,24706,15864,40570,247
kroB100.tsp,greedy-ls,greedy-cycle,N1,58,10837,16765,27602,375
kroA100.tsp,greedy-ls,random-walk,N2,10,13359,12861,26220,432
kroA100.tsp,steepest-ls,random-walk,N2,100,16163,12524,28687,302
kroB100.tsp,greedy-ls,greedy-cycle,N2,91,11194,14486,25680,42
kroA100.tsp,steepest-ls,greedy-cycle,N1,65,15198,12386,27584,56
kroA100.tsp,greedy-ls,greedy-cycle,N2,93,12016,13870,25886,10
kroB100.tsp,steepest-ls,random-walk,N1,73,27523,19528,47051,361
kroB100.tsp,greedy-ls,random-walk,N2,31,17064,11722,28786,385
kroB100.tsp,steepest-ls,greedy-cycle,N2,43,12450,13601,26051,61
kroA100.tsp,steepest-ls,greedy-cycle,N2,22,15486,12386,27872,113
kroB100.tsp,greedy-ls,random-walk,N1,99,21365,16535,37900,214
kroA100.tsp,greedy-ls,random-walk,N1,57,22402,17909,40311,241
kroB100.tsp,greedy-ls,greedy-cycle,N1,39,10342,16629,26971,23
kroB100.tsp,greedy-ls,random-walk,N1,76,25337,18734,44071,239
kroB100.tsp,steepest-ls,random-walk,N2,34,15927,12333,28260,666
kroA100.tsp,steepest-ls,greedy-cycle,N1,32,14763,11657,26420,54
kroB100.tsp,greedy-ls,random-walk,N2,89,15664,12196,27860,205
kroB100.tsp,steepest-ls,random-walk,N2,4,15190,12965,28155,352
kroA100.tsp,greedy-ls,random-walk,N2,47,18258,10665,28923,1251
kroB100.tsp,greedy-ls,greedy-cycle,N1,7,10826,16765,27591,126
kroA100.tsp,steepest-ls,random-walk,N2,6,15314,10077,25391,342
kroB100.tsp,steepest-ls,greedy-cycle,N2,14,14017,10353,24370,75
kroB100.tsp,steepest-ls,random-walk,N1,24,27138,20265,47403,481
kroB100.tsp,greedy-ls,random-walk,N2,66,13100,14877,27977,324
kroB100.tsp,greedy-ls,greedy-cycle,N2,29,11194,14354,25548,34
kroA100.tsp,greedy-ls,random-walk,N1,41,19949,20611,40560,229
kroA100.tsp,steepest-ls,greedy-cycle,N2,34,11713,14957,26670,159
kroB100.tsp,greedy-ls,random-walk,N1,60,19183,14642,33825,304
kroB100.tsp,steepest-ls,random-walk,N2,22,14480,12520,27000,274
kroA100.tsp,steepest-ls,random-walk,N2,59,16819,11019,27838,361
kroB100.tsp,steepest-ls,greedy-cycle,N1,12,11205,15678,26883,64
kroB100.tsp,greedy-ls,greedy-cycle,N1,19,15770,11825,27595,167
kroA100.tsp,greedy-ls,random-walk,N2,51,15082,12632,27714,632
kroA100.tsp,steepest-ls,greedy-cycle,N1,24,14595,11657,26252,43
kroB100.tsp,steepest-ls,random-walk,N1,32,20833,19658,40491,1849
kroB100.tsp,greedy-ls,random-walk,N2,70,17378,13024,30402,491
kroA100.tsp,steepest-ls,random-walk,N1,49,29040,17884,46924,480
kroA100.tsp,steepest-ls,greedy-cycle,N2,63,13943,11657,25600,40
kroB100.tsp,greedy-ls,greedy-cycle,N1,97,11261,15678,26939,25
kroA100.tsp,greedy-ls,random-walk,N1,16,19031,17790,36821,352
kroB100.tsp,steepest-ls,greedy-cycle,N1,45,16692,10859,27551,73
kroB100.tsp,greedy-ls,greedy-cycle,N1,78,15361,11867,27228,14
kroB100.tsp,greedy-ls,random-walk,N1,37,19814,20813,40627,421
kroB100.tsp,steepest-ls,random-walk,N2,75,17145,12411,29556,525
kroA100.tsp,greedy-ls,greedy-cycle,N1,95,11657,14581,26238,20
kroA100.tsp,steepest-ls,greedy-cycle,N2,8,14813,12784,27597,69
kroA100.tsp,steepest-ls,greedy-cycle,N1,73,11600,14330,25930,81
kroB100.tsp,greedy-ls,greedy-cycle,N2,87,12400,13791,26191,103
kroB100.tsp,steepest-ls,greedy-cycle,N2,55,14968,11907,26875,85
kroB100.tsp,steepest-ls,random-walk,N1,65,21211,18591,39802,693
kroB100.tsp,greedy-ls,random-walk,N2,27,16330,12576,28906,372
kroB100.tsp,greedy-ls,greedy-cycle,N1,8,11194,15678,26872,20
kroB100.tsp,greedy-ls,greedy-cycle,N2,68,11222,16014,27236,48
kroA100.tsp,greedy-ls,greedy-cycle,N2,85,11502,14427,25929,54
kroA100.tsp,steepest-ls,greedy-cycle,N1,72,14581,11657,26238,39
kroA100.tsp,steepest-ls,greedy-cycle,N2,9,11713,14957,26670,172
kroB100.tsp,greedy-ls,greedy-cycle,N2,86,10353,15862,26215,140
kroB100.tsp,steepest-ls,greedy-cycle,N2,54,12420,14523,26943,82
kroB100.tsp,steepest-ls,random-walk,N1,64,23339,22607,45946,768
kroB100.tsp,greedy-ls,random-walk,N2,26,16086,12863,28949,450
kroB100.tsp,greedy-ls,greedy-cycle,N1,9,10827,16739,27566,9
kroB100.tsp,greedy-ls,greedy-cycle,N2,69,10342,15503,25845,47
kroA100.tsp,greedy-ls,greedy-cycle,N2,84,14435,11657,26092,34
kroA100.tsp,steepest-ls,greedy-cycle,N2,62,11876,15476,27352,40
kroB100.tsp,greedy-ls,greedy-cycle,N1,96,16148,11305,27453,16
kroA100.tsp,greedy-ls,random-walk,N1,17,19090,13701,32791,373
kroB100.tsp,steepest-ls,greedy-cycle,N1,44,15120,11444,26564,67
kroB100.tsp,greedy-ls,greedy-cycle,N1,79,11478,16714,28192,39
kroB100.tsp,greedy-ls,random-walk,N1,36,18691,13510,32201,615
kroB100.tsp,steepest-ls,random-walk,N2,74,14489,13480,27969,293
kroA100.tsp,greedy-ls,greedy-cycle,N2,1,12532,11703,24235,31
kroA100.tsp,greedy-ls,greedy-cycle,N1,94,15486,12386,27872,29
kroB100.tsp,greedy-ls,greedy-cycle,N1,18,14697,11305,26002,265
kroA100.tsp,greedy-ls,random-walk,N2,50,16294,11245,27539,758
kroA100.tsp,steepest-ls,greedy-cycle,N1,25,11698,16222,27920,50
kroB100.tsp,steepest-ls,random-walk,N1,33,22900,21265,44165,771
kroB100.tsp,greedy-ls,random-walk,N2,71,16253,11000,27253,245
kroA100.tsp,steepest-ls,random-walk,N1,48,23180,20795,43975,369
kroA100.tsp,greedy-ls,random-walk,N1,40,21911,19115,41026,245
kroA100.tsp,steepest-ls,greedy-cycle,N2,35,11713,14957,26670,99
kroB100.tsp,greedy-ls,random-walk,N1,61,22035,14806,36841,280
kroB100.tsp,steepest-ls,random-walk,N2,23,18065,12554,30619,312
kroA100.tsp,steepest-ls,random-walk,N2,58,16002,11453,27455,319
kroB100.tsp,steepest-ls,greedy-cycle,N1,13,15054,10577,25631,113
kroA100.tsp,steepest-ls,greedy-cycle,N1,33,11657,14581,26238,132
kroB100.tsp,greedy-ls,random-walk,N2,88,17257,13398,30655,256
kroA100.tsp,steepest-ls,greedy-cycle,N2,100,12386,15198,27584,303
kroB100.tsp,steepest-ls,random-walk,N2,5,15763,11382,27145,1066
kroA100.tsp,greedy-ls,random-walk,N2,46,14973,11014,25987,1474
kroB100.tsp,greedy-ls,greedy-cycle,N1,6,14317,10617,24934,349
kroA100.tsp,steepest-ls,random-walk,N2,7,14173,9881,24054,317
kroB100.tsp,steepest-ls,greedy-cycle,N2,15,14317,10353,24670,68
kroB100.tsp,steepest-ls,random-walk,N1,25,21125,19383,40508,368
kroB100.tsp,greedy-ls,random-walk,N2,67,15840,12080,27920,225
kroB100.tsp,greedy-ls,greedy-cycle,N2,28,11194,14653,25847,23
kroA100.tsp,steepest-ls,greedy-cycle,N2,23,14435,11657,26092,73
kroB100.tsp,greedy-ls,random-walk,N1,98,22596,16344,38940,200
kroA100.tsp,greedy-ls,random-walk,N1,56,22723,18164,40887,351
kroB100.tsp,greedy-ls,greedy-cycle,N1,38,11250,15302,26552,42
kroB100.tsp,greedy-ls,random-walk,N1,77,26901,21252,48153,218
kroB100.tsp,steepest-ls,random-walk,N2,35,15418,12594,28012,571
kroB100.tsp,greedy-ls,greedy-cycle,N1,59,11205,15678,26883,383
kroA100.tsp,greedy-ls,random-walk,N2,11,17479,11983,29462,312
kroB100.tsp,greedy-ls,greedy-cycle,N2,90,11437,15192,26629,45
kroA100.tsp,steepest-ls,greedy-cycle,N1,64,11600,14330,25930,70
kroA100.tsp,greedy-ls,greedy-cycle,N2,92,11860,11119,22979,41
kroB100.tsp,steepest-ls,random-walk,N1,72,19695,20674,40369,530
kroB100.tsp,greedy-ls,random-walk,N2,30,14688,9901,24589,215
kroB100.tsp,steepest-ls,greedy-cycle,N2,42,14317,10353,24670,46
kroB100.tsp,greedy-ls,greedy-cycle,N1,80,11251,14998,26249,43
kroA100.tsp,steepest-ls,greedy-cycle,N2,74,14147,11657,25804,95
kroA100.tsp,greedy-ls,greedy-cycle,N1,82,11657,14581,26238,17
kroB100.tsp,greedy-ls,random-walk,N1,20,21919,17288,39207,248
kroB100.tsp,steepest-ls,random-walk,N2,62,13438,14513,27951,618
kroB100.tsp,steepest-ls,greedy-cycle,N1,52,12635,14757,27392,96
kroA100.tsp,steepest-ls,random-walk,N2,19,13883,12467,26350,328
kroA100.tsp,steepest-ls,random-walk,N1,72,20464,17901,38365,387
kroB100.tsp,steepest-ls,greedy-cycle,N2,39,10153,16651,26804,24
kroA100.tsp,greedy-ls,random-walk,N2,85,14190,13360,27550,242
kroB100.tsp,greedy-ls,greedy-cycle,N1,22,15252,11907,27159,415
kroB100.tsp,steepest-ls,random-walk,N2,19,15353,12847,28200,369
kroB100.tsp,greedy-ls,greedy-cycle,N1,14,15011,10771,25782,50
kroB100.tsp,steepest-ls,greedy-cycle,N1,29,11205,15678,26883,85
kroA100.tsp,steepest-ls,random-walk,N2,62,14286,13736,28022,300
kroA100.tsp,greedy-ls,random-walk,N1,95,20107,16816,36923,649
kroA100.tsp,steepest-ls,random-walk,N1,2,22162,22761,44923,487
kroA100.tsp,greedy-ls,greedy-cycle,N1,16,15489,12386,27875,22
kroA100.tsp,steepest-ls,random-walk,N1,25,24196,22127,46323,574
kroB100.tsp,greedy-ls,greedy-cycle,N2,53,10153,16783,26936,19
kroA100.tsp,steepest-ls,greedy-cycle,N1,48,12386,15198,27584,53
kroA100.tsp,greedy-ls,greedy-cycle,N2,51,11551,13366,24917,46
kroB100.tsp,steepest-ls,greedy-cycle,N2,81,11505,16324,27829,140
kroB100.tsp,greedy-ls,greedy-cycle,N1,75,11250,15415,26665,733
kroA100.tsp,steepest-ls,random-walk,N2,35,16228,14299,30527,343
kroB100.tsp,greedy-ls,greedy-cycle,N1,43,12440,14532,26972,26
kroA100.tsp,greedy-ls,greedy-cycle,N1,41,12386,15198,27584,112
kroA100.tsp,steepest-ls,greedy-cycle,N2,58,11480,14136,25616,64
kroB100.tsp,steepest-ls,greedy-cycle,N1,91,11205,15678,26883,59
kroB100.tsp,greedy-ls,greedy-cycle,N2,45,16084,10859,26943,33
kroB100.tsp,steepest-ls,random-walk,N1,48,21065,20921,41986,485
kroB100.tsp,steepest-ls,greedy-cycle,N2,78,14384,11305,25689,91
kroA100.tsp,steepest-ls,random-walk,N1,33,24245,17538,41783,507
kroA100.tsp,greedy-ls,greedy-cycle,N1,4,15198,12386,27584,19
kroB100.tsp,greedy-ls,greedy-cycle,N1,63,14408,10954,25362,310
kroB100.tsp,steepest-ls,greedy-cycle,N2,97,11194,14354,25548,77
kroA100.tsp,greedy-ls,greedy-cycle,N2,47,14123,11657,25780,18
kroB100.tsp,steepest-ls,random-walk,N2,58,16585,12813,29398,442
kroB100.tsp,greedy-ls,greedy-cycle,N1,55,15681,11733,27414,43
kroA100.tsp,steepest-ls,random-walk,N2,23,16102,11435,27537,314
kroB100.tsp,steepest-ls,greedy-cycle,N1,68,11909,16449,28358,85
kroA100.tsp,greedy-ls,random-walk,N2,9,12034,12613,24647,236
kroB100.tsp,steepest-ls,greedy-cycle,N1,87,12450,13865,26315,87
kroA100.tsp,greedy-ls,greedy-cycle,N1,57,11713,15934,27647,29
kroA100.tsp,greedy-ls,random-walk,N2,93,15169,11325,26494,260
kroA100.tsp,steepest-ls,random-walk,N1,64,21486,23305,44791,389
kroB100.tsp,greedy-ls,greedy-cycle,N2,12,11194,14475,25669,28
kroA100.tsp,greedy-ls,greedy-cycle,N2,10,14178,11657,25835,26
kroB100.tsp,steepest-ls,greedy-cycle,N2,9,10827,15415,26242,66
kroB100.tsp,greedy-ls,greedy-cycle,N1,34,10827,16739,27566,113
kroA100.tsp,greedy-ls,random-walk,N1,83,23385,19932,43317,392
kroA100.tsp,steepest-ls,random-walk,N2,74,16372,13705,30077,335
kroA100.tsp,steepest-ls,greedy-cycle,N2,19,15198,12386,27584,59
kroB100.tsp,steepest-ls,random-walk,N2,97,14833,12648,27481,675
kroA100.tsp,greedy-ls,greedy-cycle,N1,77,11915,15550,27465,20
kroA100.tsp,greedy-ls,greedy-cycle,N1,98,14763,11657,26420,16
kroA100.tsp,steepest-ls,greedy-cycle,N2,81,11698,15245,26943,93
kroB100.tsp,steepest-ls,random-walk,N2,78,15087,13308,28395,490
kroB100.tsp,greedy-ls,greedy-cycle,N1,75,11250,15415,26665,25
kroB100.tsp,steepest-ls,greedy-cycle,N1,48,14408,10577,24985,605
kroB100.tsp,greedy-ls,greedy-cycle,N1,43,12440,14345,26785,549
kroB100.tsp,steepest-ls,random-walk,N1,87,21736,18485,40221,477
kroA100.tsp,steepest-ls,greedy-cycle,N2,5,11502,14424,25926,102
kroA100.tsp,greedy-ls,greedy-cycle,N2,67,13148,12676,25824,23
kroA100.tsp,steepest-ls,greedy-cycle,N1,91,14770,11657,26427,34
kroA100.tsp,greedy-ls,greedy-cycle,N2,88,15489,12386,27875,29
kroB100.tsp,greedy-ls,greedy-cycle,N1,5,10288,16742,27030,21
kroB100.tsp,greedy-ls,greedy-cycle,N2,65,11283,16605,27888,35
kroB100.tsp,steepest-ls,random-walk,N1,68,23155,17867,41022,501
kroB100.tsp,steepest-ls,greedy-cycle,N2,58,10837,15384,26221,103
kroA100.tsp,steepest-ls,random-walk,N1,13,22947,25810,48757,622
kroA100.tsp,steepest-ls,greedy-cycle,N2,39,12333,15083,27416,96
kroA100.tsp,greedy-ls,greedy-cycle,N1,20,11669,16156,27825,35
kroB100.tsp,greedy-ls,random-walk,N1,82,25577,15597,41174,201
kroA100.tsp,steepest-ls,random-walk,N2,54,15449,11199,26648,298
kroB100.tsp,greedy-ls,greedy-cycle,N1,22,15267,11907,27174,41
kroA100.tsp,greedy-ls,greedy-cycle,N2,30,12333,15086,27419,20
kroA100.tsp,steepest-ls,greedy-cycle,N1,29,12386,15198,27584,49
kroB100.tsp,greedy-ls,random-walk,N2,92,16778,12279,29057,400
kroB100.tsp,greedy-ls,greedy-cycle,N1,14,14899,11871,26770,226
kroA100.tsp,steepest-ls,random-walk,N1,44,24214,21116,45330,628
kroB100.tsp,greedy-ls,greedy-cycle,N2,32,11194,14532,25726,68
kroB100.tsp,greedy-ls,random-walk,N1,94,25293,16835,42128,227
kroA100.tsp,greedy-ls,greedy-cycle,N1,36,14581,11657,26238,19
kroB100.tsp,steepest-ls,random-walk,N2,39,15474,13774,29248,718
kroB100.tsp,greedy-ls,greedy-cycle,N1,34,10827,16739,27566,21
kroA100.tsp,steepest-ls,random-walk,N2,42,15327,12143,27470,307
kroB100.tsp,greedy-ls,random-walk,N2,7,14673,12719,27392,214
kroB100.tsp,steepest-ls,random-walk,N2,9,15506,12522,28028,407
kroB100.tsp,greedy-ls,random-walk,N2,84,16046,10867,26913,446
kroA100.tsp,greedy-ls,greedy-cycle,N2,26,15198,12386,27584,25
kroB100.tsp,greedy-ls,greedy-cycle,N2,24,14525,11825,26350,34
kroB100.tsp,steepest-ls,random-walk,N1,29,21686,23185,44871,1263
kroA100.tsp,steepest-ls,random-walk,N1,52,19138,21856,40994,504
kroB100.tsp,steepest-ls,greedy-cycle,N2,19,14206,11305,25511,57
kroA100.tsp,greedy-ls,greedy-cycle,N1,61,11551,13815,25366,54
kroA100.tsp,steepest-ls,greedy-cycle,N2,78,11502,14424,25926,164
kroB100.tsp,steepest-ls,random-walk,N2,81,13879,10895,24774,529
kroA100.tsp,steepest-ls,random-walk,N2,15,15457,12542,27999,331
kroB100.tsp,greedy-ls,greedy-cycle,N1,63,14295,11326,25621,37
kroA100.tsp,steepest-ls,greedy-cycle,N2,97,15198,12386,27584,111
kroA100.tsp,steepest-ls,greedy-cycle,N1,68,11502,15434,26936,51
kroA100.tsp,greedy-ls,greedy-cycle,N2,71,12386,15198,27584,22
kroB100.tsp,steepest-ls,random-walk,N1,91,22533,18116,40649,859
kroB100.tsp,greedy-ls,greedy-cycle,N1,55,15350,11907,27257,262
kroB100.tsp,greedy-ls,greedy-cycle,N2,73,11108,14124,25232,68
kroA100.tsp,steepest-ls,greedy-cycle,N1,87,11698,15934,27632,48
kroA100.tsp,greedy-ls,random-walk,N1,99,22270,18325,40595,292
kroB100.tsp,steepest-ls,greedy-cycle,N1,25,10827,16739,27566,27
kroB100.tsp,greedy-ls,greedy-cycle,N1,18,14697,11222,25919,36
kroB100.tsp,greedy-ls,random-walk,N1,2,23674,19505,43179,579
kroB100.tsp,greedy-ls,random-walk,N1,57,25613,17359,42972,223
kroB100.tsp,steepest-ls,random-walk,N2,15,16224,11130,27354,345
kroA100.tsp,steepest-ls,random-walk,N2,81,14503,11594,26097,290
kroA100.tsp,greedy-ls,random-walk,N1,76,23167,18417,41584,753
kroA100.tsp,greedy-ls,random-walk,N2,89,16431,14522,30953,272
kroB100.tsp,steepest-ls,greedy-cycle,N2,35,10827,15415,26242,55
kroB100.tsp,greedy-ls,random-walk,N2,47,17425,13120,30545,424
kroA100.tsp,steepest-ls,greedy-cycle,N1,13,11657,14581,26238,42
kroA100.tsp,steepest-ls,random-walk,N1,91,24614,18673,43287,339
kroA100.tsp,greedy-ls,random-walk,N2,66,14723,13326,28049,246
kroB100.tsp,steepest-ls,random-walk,N2,42,16166,13674,29840,398
kroB100.tsp,steepest-ls,greedy-cycle,N1,72,11316,17195,28511,46
kroA100.tsp,steepest-ls,random-walk,N2,39,16534,11375,27909,324
kroA100.tsp,greedy-ls,random-walk,N1,21,20126,18289,38415,301
kroA100.tsp,steepest-ls,greedy-cycle,N2,54,11502,14991,26493,72
kroB100.tsp,steepest-ls,random-walk,N1,52,20835,15652,36487,557
kroB100.tsp,greedy-ls,random-walk,N2,10,15950,10491,26441,198
kroA100.tsp,steepest-ls,random-walk,N1,29,19923,20162,40085,538
kroB100.tsp,steepest-ls,greedy-cycle,N2,62,10344,13876,24220,108
kroB100.tsp,greedy-ls,greedy-cycle,N1,96,15378,11867,27245,552
kroB100.tsp,greedy-ls,greedy-cycle,N1,79,11478,16714,28192,537
kroA100.tsp,greedy-ls,random-walk,N2,31,16248,13357,29605,252
kroA100.tsp,steepest-ls,greedy-cycle,N1,44,11600,14330,25930,72
kroB100.tsp,steepest-ls,greedy-cycle,N1,64,14899,10763,25662,112
kroB100.tsp,greedy-ls,greedy-cycle,N1,59,11205,15678,26883,30
kroB100.tsp,greedy-ls,random-walk,N1,16,19869,13614,33483,391
kroB100.tsp,steepest-ls,random-walk,N2,54,17325,11018,28343,375
kroA100.tsp,steepest-ls,greedy-cycle,N2,42,11860,10969,22829,149
kroA100.tsp,greedy-ls,random-walk,N2,5,15005,13401,28406,432
kroA100.tsp,greedy-ls,random-walk,N1,37,19355,21517,40872,260
kroB100.tsp,greedy-ls,greedy-cycle,N1,80,11027,15534,26561,497
kroB100.tsp,steepest-ls,greedy-cycle,N2,74,12450,13601,26051,73
kroB100.tsp,steepest-ls,random-walk,N1,44,28712,20226,48938,740
kroB100.tsp,greedy-ls,greedy-cycle,N2,49,10191,15224,25415,36
kroA100.tsp,steepest-ls,greedy-cycle,N1,52,11502,15434,26936,49
kroA100.tsp,greedy-ls,random-walk,N2,27,13496,13434,26930,208
kroA100.tsp,greedy-ls,greedy-cycle,N1,8,14813,12784,27597,18
kroB100.tsp,greedy-ls,random-walk,N1,41,20581,19815,40396,224
kroA100.tsp,steepest-ls,random-walk,N2,78,15980,11720,27700,359
kroB100.tsp,steepest-ls,greedy-cycle,N1,33,14317,10763,25080,52
kroA100.tsp,greedy-ls,random-walk,N1,60,21871,19973,41844,326
kroA100.tsp,steepest-ls,random-walk,N2,97,15593,12462,28055,326
kroA100.tsp,steepest-ls,greedy-cycle,N2,15,14435,11657,26092,104
kroB100.tsp,steepest-ls,random-walk,N1,13,21386,22961,44347,430
kroB100.tsp,greedy-ls,random-walk,N2,51,14348,11000,25348,249
kroB100.tsp,steepest-ls,greedy-cycle,N2,23,14968,11907,26875,47
kroA100.tsp,steepest-ls,random-walk,N1,68,22389,16618,39007,497
kroB100.tsp,greedy-ls,greedy-cycle,N1,38,11250,15302,26552,304
kroB100.tsp,steepest-ls,greedy-cycle,N2,5,10099,16651,26750,32
kroA100.tsp,greedy-ls,random-walk,N2,70,15833,11813,27646,340
kroA100.tsp,steepest-ls,random-walk,N1,87,23279,24647,47926,423
kroA100.tsp,steepest-ls,greedy-cycle,N2,82,11657,14435,26092,47
kroB100.tsp,greedy-ls,random-walk,N1,39,21338,20352,41690,302
kroB100.tsp,greedy-ls,greedy-cycle,N1,76,11194,15678,26872,26
kroB100.tsp,steepest-ls,random-walk,N2,94,17333,12062,29395,404
kroB100.tsp,greedy-ls,greedy-cycle,N1,99,11194,15678,26872,22
kroA100.tsp,greedy-ls,greedy-cycle,N1,74,14595,11657,26252,15
kroA100.tsp,greedy-ls,random-walk,N1,18,19090,14455,33545,328
kroA100.tsp,steepest-ls,random-walk,N1,10,18482,19484,37966,414
kroA100.tsp,steepest-ls,greedy-cycle,N1,92,11860,11668,23528,91
kroA100.tsp,greedy-ls,random-walk,N1,3,19510,19911,39421,734
kroB100.tsp,greedy-ls,greedy-cycle,N2,66,13248,12839,26087,29
kroB100.tsp,greedy-ls,greedy-cycle,N1,6,14204,11126,25330,27
kroB100.tsp,greedy-ls,random-walk,N2,29,16831,13679,30510,304
kroB100.tsp,greedy-ls,greedy-cycle,N2,89,12268,13791,26059,50
kroB100.tsp,steepest-ls,random-walk,N1,84,23167,20046,43213,643
kroA100.tsp,greedy-ls,greedy-cycle,N2,64,11696,16215,27911,47
kroA100.tsp,steepest-ls,greedy-cycle,N2,6,15513,12386,27899,50
kroB100.tsp,greedy-ls,greedy-cycle,N1,40,10342,16629,26971,191
kroB100.tsp,steepest-ls,greedy-cycle,N1,3,11119,15138,26257,63
kroB100.tsp,greedy-ls,greedy-cycle,N1,21,12191,16227,28418,24
kroA100.tsp,steepest-ls,random-walk,N2,57,13974,14399,28373,456
kroA100.tsp,greedy-ls,greedy-cycle,N1,23,14770,11657,26427,22
kroB100.tsp,greedy-ls,random-walk,N1,81,17703,17565,35268,289
kroB100.tsp,greedy-ls,greedy-cycle,N2,31,13804,9850,23654,32
kroA100.tsp,steepest-ls,random-walk,N1,47,24293,17456,41749,443
kroB100.tsp,greedy-ls,greedy-cycle,N1,17,16490,10859,27349,446
kroA100.tsp,greedy-ls,greedy-cycle,N2,33,11657,14435,26092,29
kroB100.tsp,greedy-ls,random-walk,N2,91,14535,12468,27003,283
kroA100.tsp,steepest-ls,random-walk,N2,41,14392,11641,26033,337
kroB100.tsp,greedy-ls,random-walk,N1,78,19170,25314,44484,225
kroB100.tsp,greedy-ls,greedy-cycle,N1,37,11316,17195,28511,30
kroB100.tsp,greedy-ls,random-walk,N1,97,21689,18616,40305,195
kroA100.tsp,greedy-ls,greedy-cycle,N1,35,11713,15934,27647,24
kroA100.tsp,greedy-ls,random-walk,N1,59,23793,17203,40996,267
kroA100.tsp,steepest-ls,random-walk,N1,51,25163,18073,43236,416
kroA100.tsp,steepest-ls,random-walk,N2,8,15455,11941,27396,350
kroB100.tsp,greedy-ls,greedy-cycle,N2,27,10827,15415,26242,17
kroB100.tsp,greedy-ls,random-walk,N2,68,15781,12270,28051,228
kroB100.tsp,greedy-ls,random-walk,N2,87,17438,13430,30868,257
kroA100.tsp,greedy-ls,greedy-cycle,N2,25,11830,15646,27476,29
kroB100.tsp,greedy-ls,greedy-cycle,N1,9,10827,16739,27566,168
kroB100.tsp,greedy-ls,random-walk,N2,4,14609,14462,29071,182
kroA100.tsp,greedy-ls,random-walk,N2,49,14472,12254,26726,775
kroB100.tsp,greedy-ls,greedy-cycle,N1,60,12450,13678,26128,41
kroA100.tsp,steepest-ls,greedy-cycle,N2,94,15486,12386,27872,49
kroA100.tsp,steepest-ls,random-walk,N2,16,14491,11779,26270,713
kroA100.tsp,greedy-ls,greedy-cycle,N1,62,11762,15630,27392,30
kroB100.tsp,steepest-ls,random-walk,N2,82,16255,12563,28818,396
kroB100.tsp,greedy-ls,greedy-cycle,N2,70,10153,16670,26823,33
kroA100.tsp,steepest-ls,greedy-cycle,N1,84,14581,11657,26238,36
kroB100.tsp,greedy-ls,greedy-cycle,N1,56,10904,15349,26253,315
kroA100.tsp,greedy-ls,greedy-cycle,N2,72,14435,11657,26092,24
kroB100.tsp,steepest-ls,random-walk,N1,92,23262,21715,44977,664
kroA100.tsp,steepest-ls,random-walk,N2,82,14898,12038,26936,343
kroA100.tsp,greedy-ls,random-walk,N1,75,22207,20471,42678,776
kroA100.tsp,greedy-ls,greedy-cycle,N1,19,15198,12386,27584,32
kroB100.tsp,greedy-ls,random-walk,N1,1,23842,15209,39051,991
kroB100.tsp,steepest-ls,random-walk,N2,16,15946,13535,29481,279
kroB100.tsp,greedy-ls,random-walk,N1,54,19612,17722,37334,368
kroB100.tsp,steepest-ls,greedy-cycle,N1,26,10730,14227,24957,73
kroA100.tsp,steepest-ls,random-walk,N1,92,19976,15955,35931,517
kroA100.tsp,greedy-ls,random-walk,N2,65,14263,10811,25074,245
kroA100.tsp,steepest-ls,greedy-cycle,N1,10,14595,11657,26252,41
kroB100.tsp,greedy-ls,random-walk,N2,44,16098,12680,28778,338
kroB100.tsp,steepest-ls,greedy-cycle,N2,36,14882,10859,25741,69
kroA100.tsp,steepest-ls,greedy-cycle,N2,57,11713,14957,26670,65
kroA100.tsp,greedy-ls,random-walk,N1,22,20245,18169,38414,458
kroB100.tsp,steepest-ls,greedy-cycle,N1,71,11205,15678,26883,41
kroB100.tsp,steepest-ls,random-walk,N2,41,12943,12626,25569,416
kroA100.tsp,steepest-ls,greedy-cycle,N1,47,14995,11657,26652,32
kroA100.tsp,greedy-ls,random-walk,N2,32,15920,9801,25721,251
kroB100.tsp,steepest-ls,greedy-cycle,N2,61,10827,15415,26242,82
kroB100.tsp,greedy-ls,greedy-cycle,N1,95,12191,16227,28418,377
kroB100.tsp,greedy-ls,random-walk,N2,13,15923,12832,28755,195
kroB100.tsp,steepest-ls,random-walk,N1,51,22381,16588,38969,583
kroB100.tsp,steepest-ls,greedy-cycle,N1,88,15347,11907,27254,66
kroA100.tsp,greedy-ls,random-walk,N2,6,15224,9772,24996,249
kroA100.tsp,greedy-ls,random-walk,N1,34,18167,17952,36119,210
kroB100.tsp,greedy-ls,greedy-cycle,N2,3,11108,13992,25100,29
kroA100.tsp,greedy-ls,greedy-cycle,N1,58,11480,15146,26626,43
kroA100.tsp,steepest-ls,greedy-cycle,N2,41,12386,15198,27584,53
kroB100.tsp,steepest-ls,random-walk,N2,57,15490,10167,25657,602
kroB100.tsp,greedy-ls,random-walk,N1,15,19217,23035,42252,325
kroB100.tsp,steepest-ls,greedy-cycle,N1,67,10288,16742,27030,43
kroA100.tsp,steepest-ls,greedy-cycle,N1,3,12386,15198,27584,52
kroB100.tsp,steepest-ls,greedy-cycle,N2,98,11194,14354,25548,144
kroA100.tsp,greedy-ls,random-walk,N2,24,15428,10556,25984,208
kroA100.tsp,steepest-ls,greedy-cycle,N1,51,11698,15934,27632,47
kroA100.tsp,greedy-ls,greedy-cycle,N2,48,12386,15198,27584,59
kroB100.tsp,steepest-ls,random-walk,N1,47,21505,19198,40703,538
kroB100.tsp,greedy-ls,greedy-cycle,N1,83,14204,10985,25189,429
kroB100.tsp,steepest-ls,greedy-cycle,N2,77,14384,11305,25689,119
kroA100.tsp,steepest-ls,greedy-cycle,N2,16,15486,12386,27872,89
kroA100.tsp,greedy-ls,random-walk,N1,63,18073,18722,36795,304
kroA100.tsp,steepest-ls,random-walk,N2,94,14982,11231,26213,354
kroB100.tsp,steepest-ls,greedy-cycle,N1,30,11027,15534,26561,301
kroB100.tsp,greedy-ls,random-walk,N1,42,22248,17810,40058,242
kroB100.tsp,steepest-ls,greedy-cycle,N2,6,14317,10353,24670,66
kroA100.tsp,greedy-ls,random-walk,N2,73,16886,10027,26913,210
kroA100.tsp,steepest-ls,random-walk,N1,84,19365,17865,37230,544
kroB100.tsp,steepest-ls,greedy-cycle,N2,20,10838,15443,26281,56
kroB100.tsp,greedy-ls,random-walk,N2,52,14411,12640,27051,187
kroB100.tsp,steepest-ls,random-walk,N1,10,23866,17487,41353,487
kroB100.tsp,greedy-ls,random-walk,N2,25,15307,12771,28078,364
kroB100.tsp,steepest-ls,random-walk,N1,67,25548,19710,45258,406
kroA100.tsp,greedy-ls,greedy-cycle,N2,87,11830,15358,27188,28
kroB100.tsp,steepest-ls,greedy-cycle,N2,57,10827,15415,26242,207
kroA100.tsp,steepest-ls,greedy-cycle,N1,71,12386,15198,27584,52
kroA100.tsp,greedy-ls,greedy-cycle,N2,68,11502,14571,26073,40
kroB100.tsp,steepest-ls,random-walk,N1,88,23745,17936,41681,399
kroB100.tsp,greedy-ls,greedy-cycle,N2,85,11108,14083,25191,31
kroB100.tsp,steepest-ls,random-walk,N2,77,15621,12105,27726,382
kroB100.tsp,greedy-ls,random-walk,N1,35,21511,19623,41134,518
kroA100.tsp,greedy-ls,greedy-cycle,N2,2,11502,14991,26493,25
kroA100.tsp,greedy-ls,greedy-cycle,N1,97,15198,12386,27584,22
kroB100.tsp,steepest-ls,greedy-cycle,N1,47,11219,16084,27303,187
kroA100.tsp,greedy-ls,random-walk,N1,14,22507,15133,37640,277
kroA100.tsp,greedy-ls,greedy-cycle,N1,78,11502,15437,26939,25
kroA100.tsp,steepest-ls,greedy-cycle,N2,61,11698,14957,26655,52
kroB100.tsp,greedy-ls,greedy-cycle,N1,95,12238,16228,28466,28
kroB100.tsp,steepest-ls,random-walk,N2,98,16286,13800,30086,379
kroB100.tsp,greedy-ls,random-walk,N2,72,15835,14742,30577,181
kroB100.tsp,steepest-ls,random-walk,N1,30,19555,15696,35251,1402
kroA100.tsp,steepest-ls,greedy-cycle,N1,26,15198,12386,27584,61
kroA100.tsp,greedy-ls,random-walk,N2,53,14285,12638,26923,961
kroB100.tsp,steepest-ls,greedy-cycle,N1,10,11909,16449,28358,70
kroB100.tsp,steepest-ls,random-walk,N2,20,14609,12557,27166,365
kroB100.tsp,greedy-ls,random-walk,N1,62,18576,21524,40100,233
kroA100.tsp,steepest-ls,greedy-cycle,N2,36,14435,11657,26092,39
kroA100.tsp,greedy-ls,random-walk,N1,43,25467,19485,44952,208
kroB100.tsp,greedy-ls,random-walk,N2,64,16422,9035,25457,842
kroB100.tsp,steepest-ls,random-walk,N1,26,17646,19665,37311,657
kroA100.tsp,steepest-ls,random-walk,N2,4,13057,12569,25626,313
kroB100.tsp,steepest-ls,greedy-cycle,N2,16,14384,11305,25689,49
kroB100.tsp,steepest-ls,random-walk,N2,6,15641,12789,28430,1063
kroA100.tsp,greedy-ls,random-walk,N2,45,14169,14752,28921,341
kroB100.tsp,greedy-ls,greedy-cycle,N1,5,10575,16629,27204,114
kroB100.tsp,greedy-ls,random-walk,N2,8,15944,14461,30405,192
kroA100.tsp,greedy-ls,greedy-cycle,N2,29,12386,15198,27584,34
kroA100.tsp,steepest-ls,greedy-cycle,N1,30,12333,15083,27416,68
kroB100.tsp,steepest-ls,random-walk,N2,36,17070,12734,29804,884
kroB100.tsp,greedy-ls,random-walk,N1,74,19050,16131,35181,275
kroA100.tsp,greedy-ls,random-walk,N1,55,25502,18231,43733,273
kroA100.tsp,steepest-ls,greedy-cycle,N2,20,11713,14957,26670,97
kroA100.tsp,greedy-ls,greedy-cycle,N1,39,12333,15083,27416,30
kroB100.tsp,steepest-ls,greedy-cycle,N2,41,14882,10859,25741,72
kroA100.tsp,steepest-ls,greedy-cycle,N1,88,15486,12386,27872,59
kroA100.tsp,greedy-ls,greedy-cycle,N2,91,14164,11657,25821,17
kroB100.tsp,greedy-ls,random-walk,N2,33,18389,12198,30587,206
kroB100.tsp,steepest-ls,random-walk,N1,71,27261,19085,46346,397
kroB100.tsp,greedy-ls,greedy-cycle,N2,93,11108,13992,25100,38
kroA100.tsp,steepest-ls,greedy-cycle,N1,67,13148,12828,25976,50
kroA100.tsp,greedy-ls,random-walk,N2,12,15101,11424,26525,258
kroB100.tsp,steepest-ls,greedy-cycle,N1,51,14408,10763,25171,71
kroA100.tsp,greedy-ls,greedy-cycle,N1,81,11551,14139,25690,42
kroA100.tsp,steepest-ls,greedy-cycle,N2,98,14428,11657,26085,53
kroB100.tsp,steepest-ls,random-walk,N2,61,16549,11500,28049,357
kroB100.tsp,greedy-ls,random-walk,N1,23,26194,20729,46923,257
kroB100.tsp,greedy-ls,greedy-cycle,N1,83,13672,10312,23984,37
kroA100.tsp,steepest-ls,greedy-cycle,N2,77,11876,15476,27352,50
kroB100.tsp,greedy-ls,random-walk,N1,100,21280,20778,42058,199
kroB100.tsp,greedy-ls,greedy-cycle,N1,21,12238,16228,28466,336
kroA100.tsp,greedy-ls,random-walk,N2,69,14271,10945,25216,195
kroA100.tsp,steepest-ls,random-walk,N1,71,23341,16080,39421,457
kroA100.tsp,greedy-ls,random-walk,N2,86,13154,12247,25401,591
kroB100.tsp,greedy-ls,random-walk,N2,48,14131,13170,27301,198
kroA100.tsp,steepest-ls,random-walk,N1,1,22162,22761,44923,758
kroA100.tsp,greedy-ls,greedy-cycle,N1,15,14700,11657,26357,28
kroA100.tsp,greedy-ls,random-walk,N1,79,21080,18007,39087,582
kroA100.tsp,steepest-ls,random-walk,N2,61,14707,12105,26812,353
kroA100.tsp,greedy-ls,random-walk,N1,96,21641,19144,40785,292
kroB100.tsp,steepest-ls,random-walk,N1,3,25790,18924,44714,697
kroB100.tsp,greedy-ls,random-walk,N1,58,25981,20577,46558,219
kroB100.tsp,greedy-ls,greedy-cycle,N1,17,16619,10859,27478,18
kroB100.tsp,steepest-ls,greedy-cycle,N2,82,14017,10353,24370,240
kroB100.tsp,greedy-ls,greedy-cycle,N1,76,11194,15678,26872,1083
kroA100.tsp,greedy-ls,greedy-cycle,N2,52,11502,14705,26207,53
kroB100.tsp,greedy-ls,greedy-cycle,N2,50,15164,11807,26971,31
kroB100.tsp,greedy-ls,greedy-cycle,N1,99,11205,15678,26883,138
kroA100.tsp,steepest-ls,random-walk,N1,26,24268,14533,38801,545
kroB100.tsp,steepest-ls,greedy-cycle,N1,92,15985,11305,27290,99
kroA100.tsp,greedy-ls,greedy-cycle,N1,42,13485,12074,25559,50
kroB100.tsp,greedy-ls,greedy-cycle,N1,40,10342,16742,27084,36
kroA100.tsp,steepest-ls,random-walk,N2,36,16521,13579,30100,337
kroA100.tsp,greedy-ls,greedy-cycle,N2,44,11502,15216,26718,24
kroB100.tsp,greedy-ls,greedy-cycle,N1,60,12407,14482,26889,1073
kroA100.tsp,greedy-ls,greedy-cycle,N1,7,11669,16156,27825,25
kroA100.tsp,greedy-ls,random-walk,N2,28,16268,11409,27677,257
kroB100.tsp,steepest-ls,greedy-cycle,N2,94,10827,15415,26242,66
kroA100.tsp,steepest-ls,random-walk,N1,30,20832,18666,39498,681
kroB100.tsp,greedy-ls,greedy-cycle,N2,46,10827,15536,26363,32
kroA100.tsp,greedy-ls,greedy-cycle,N1,54,11600,14330,25930,102
kroA100.tsp,greedy-ls,random-walk,N1,38,19646,19437,39083,275
kroB100.tsp,steepest-ls,greedy-cycle,N1,84,10826,16765,27591,30
kroA100.tsp,steepest-ls,random-walk,N2,20,14245,12286,26531,351
kroB100.tsp,greedy-ls,random-walk,N1,19,24057,19538,43595,367
kroB100.tsp,greedy-ls,greedy-cycle,N1,56,10708,13854,24562,64
kroA100.tsp,steepest-ls,random-walk,N1,88,23777,20976,44753,502
kroB100.tsp,greedy-ls,greedy-cycle,N1,37,11256,17026,28282,746
kroA100.tsp,greedy-ls,greedy-cycle,N2,13,11657,14435,26092,24
kroB100.tsp,greedy-ls,greedy-cycle,N2,11,11108,13946,25054,30
kroA100.tsp,greedy-ls,random-walk,N2,90,16642,13958,30600,195
kroA100.tsp,steepest-ls,random-walk,N1,67,23303,20068,43371,392
kroA100.tsp,steepest-ls,random-walk,N2,98,15363,13938,29301,292
kroA100.tsp,greedy-ls,random-walk,N1,80,20203,19251,39454,482
kroA100.tsp,steepest-ls,random-walk,N2,77,14966,12778,27744,346
kroA100.tsp,steepest-ls,random-walk,N2,99,15055,9204,24259,348
kroA100.tsp,greedy-ls,random-walk,N1,81,20212,19554,39766,377
kroA100.tsp,steepest-ls,random-walk,N2,76,14257,12560,26817,359
kroA100.tsp,steepest-ls,random-walk,N1,89,22812,21414,44226,495
kroB100.tsp,greedy-ls,greedy-cycle,N1,36,16703,10859,27562,243
kroA100.tsp,greedy-ls,greedy-cycle,N2,12,12439,14916,27355,21
kroB100.tsp,greedy-ls,greedy-cycle,N2,10,10896,15907,26803,27
kroA100.tsp,greedy-ls,random-walk,N2,91,14790,13434,28224,228
kroA100.tsp,steepest-ls,random-walk,N1,66,22065,18328,40393,451
kroA100.tsp,greedy-ls,greedy-cycle,N1,55,11669,16156,27825,32
kroA100.tsp,greedy-ls,random-walk,N1,39,20699,18995,39694,232
kroB100.tsp,steepest-ls,greedy-cycle,N1,85,11119,15138,26257,42
kroA100.tsp,steepest-ls,random-walk,N2,21,15361,12907,28268,383
kroB100.tsp,greedy-ls,random-walk,N1,18,19540,21395,40935,195
kroB100.tsp,greedy-ls,greedy-cycle,N1,57,10827,16739,27566,11
kroA100.tsp,greedy-ls,greedy-cycle,N2,45,14164,11657,25821,31
kroB100.tsp,greedy-ls,greedy-cycle,N1,61,10827,16739,27566,581
kroA100.tsp,greedy-ls,greedy-cycle,N1,6,15513,12386,27899,16
kroA100.tsp,greedy-ls,random-walk,N2,29,13426,12586,26012,203
kroB100.tsp,steepest-ls,greedy-cycle,N2,95,11506,14572,26078,86
kroA100.tsp,steepest-ls,random-walk,N1,31,26618,19414,46032,610
kroB100.tsp,greedy-ls,greedy-cycle,N2,47,10708,16278,26986,32
kroB100.tsp,steepest-ls,greedy-cycle,N1,93,11119,15138,26257,44
kroA100.tsp,greedy-ls,greedy-cycle,N1,43,12386,15198,27584,38
kroB100.tsp,greedy-ls,greedy-cycle,N1,41,16703,10859,27562,29
kroA100.tsp,steepest-ls,random-walk,N2,37,15942,14126,30068,304
kroB100.tsp,steepest-ls,greedy-cycle,N2,83,14317,10353,24670,95
kroB100.tsp,greedy-ls,greedy-cycle,N1,77,14993,11305,26298,839
kroA100.tsp,greedy-ls,greedy-cycle,N2,53,15489,12487,27976,37
kroB100.tsp,greedy-ls,greedy-cycle,N2,51,12979,9318,22297,55
kroB100.tsp,greedy-ls,greedy-cycle,N1,98,11220,15678,26898,192
kroA100.tsp,steepest-ls,random-walk,N1,27,22232,26799,49031,447
kroB100.tsp,greedy-ls,greedy-cycle,N1,100,11010,15938,26948,24
kroA100.tsp,greedy-ls,greedy-cycle,N1,14,12386,15198,27584,25
kroA100.tsp,greedy-ls,random-walk,N1,78,22038,22161,44199,394
kroA100.tsp,steepest-ls,random-walk,N2,60,16643,10578,27221,286
kroA100.tsp,greedy-ls,random-walk,N1,97,25635,16653,42288,569
kroB100.tsp,steepest-ls,random-walk,N1,2,23969,21236,45205,517
kroB100.tsp,greedy-ls,random-walk,N1,59,19534,15140,34674,249
kroB100.tsp,greedy-ls,greedy-cycle,N1,16,14238,11305,25543,72
kroB100.tsp,greedy-ls,greedy-cycle,N1,20,11040,15418,26458,794
kroA100.tsp,greedy-ls,random-walk,N2,68,14830,9709,24539,217
kroA100.tsp,steepest-ls,random-walk,N1,70,20936,17490,38426,502
kroA100.tsp,greedy-ls,random-walk,N2,87,16927,13485,30412,554
kroB100.tsp,greedy-ls,random-walk,N2,49,16381,13116,29497,231
kroB100.tsp,steepest-ls,greedy-cycle,N1,50,15384,11807,27191,61
kroA100.tsp,steepest-ls,greedy-cycle,N2,99,14435,11657,26092,54
kroA100.tsp,greedy-ls,greedy-cycle,N1,80,13485,12074,25559,28
kroB100.tsp,steepest-ls,random-walk,N2,60,15132,13025,28157,351
kroB100.tsp,greedy-ls,random-walk,N1,22,18251,20092,38343,212
kroB100.tsp,greedy-ls,greedy-cycle,N1,82,14899,10763,25662,30
kroA100.tsp,steepest-ls,greedy-cycle,N2,76,11657,14435,26092,59
kroA100.tsp,greedy-ls,greedy-cycle,N1,100,12386,15198,27584,26
kroB100.tsp,steepest-ls,greedy-cycle,N2,40,10153,16651,26804,24
kroA100.tsp,greedy-ls,greedy-cycle,N2,90,15513,12386,27899,18
kroA100.tsp,steepest-ls,greedy-cycle,N1,89,11860,11668,23528,108
kroB100.tsp,greedy-ls,random-walk,N2,32,15482,10579,26061,250
kroB100.tsp,steepest-ls,random-walk,N1,70,26039,18836,44875,607
kroB100.tsp,greedy-ls,greedy-cycle,N2,92,14631,11867,26498,55
kroA100.tsp,steepest-ls,greedy-cycle,N1,66,15198,12386,27584,55
kroA100.tsp,greedy-ls,random-walk,N2,13,13109,13450,26559,301
kroB100.tsp,steepest-ls,random-walk,N2,37,14893,13434,28327,452
kroB100.tsp,greedy-ls,random-walk,N1,75,20077,20023,40100,245
kroA100.tsp,greedy-ls,random-walk,N1,54,21598,17197,38795,329
kroA100.tsp,greedy-ls,greedy-cycle,N1,38,14581,11657,26238,16
kroA100.tsp,steepest-ls,greedy-cycle,N2,21,14435,11657,26092,49
kroB100.tsp,greedy-ls,random-walk,N2,65,16681,10155,26836,375
kroB100.tsp,steepest-ls,random-walk,N1,27,22404,18351,40755,417
kroA100.tsp,steepest-ls,random-walk,N2,5,15799,12388,28187,353
kroB100.tsp,steepest-ls,greedy-cycle,N2,17,14882,10859,25741,124
kroB100.tsp,steepest-ls,random-walk,N2,7,13494,14464,27958,599
kroA100.tsp,greedy-ls,random-walk,N2,44,16413,10448,26861,473
kroB100.tsp,greedy-ls,greedy-cycle,N1,4,13785,10680,24465,136
kroB100.tsp,greedy-ls,random-walk,N2,9,16061,11247,27308,209
kroA100.tsp,steepest-ls,greedy-cycle,N1,31,11860,11668,23528,277
kroA100.tsp,greedy-ls,greedy-cycle,N2,28,13148,12325,25473,29
kroB100.tsp,steepest-ls,greedy-cycle,N1,11,11119,15138,26257,44
kroB100.tsp,steepest-ls,random-walk,N2,21,16101,13923,30024,273
kroB100.tsp,greedy-ls,random-walk,N1,63,19293,22757,42050,217
kroA100.tsp,steepest-ls,greedy-cycle,N2,37,11502,14424,25926,69
kroA100.tsp,greedy-ls,random-walk,N1,42,26319,20783,47102,195
kroB100.tsp,greedy-ls,random-walk,N2,73,17698,10557,28255,221
kroB100.tsp,steepest-ls,random-walk,N1,31,20756,17795,38551,521
kroA100.tsp,steepest-ls,greedy-cycle,N1,27,11713,15934,27647,69
kroA100.tsp,greedy-ls,random-walk,N2,52,13621,11683,25304,677
kroA100.tsp,greedy-ls,greedy-cycle,N2,3,12386,15198,27584,19
kroB100.tsp,steepest-ls,random-walk,N2,76,14520,12243,26763,383
kroB100.tsp,greedy-ls,random-walk,N1,34,25555,13513,39068,927
kroA100.tsp,greedy-ls,greedy-cycle,N1,96,11600,14287,25887,37
kroB100.tsp,steepest-ls,greedy-cycle,N1,46,10827,16739,27566,36
kroA100.tsp,greedy-ls,random-walk,N1,15,23720,20868,44588,349
kroA100.tsp,steepest-ls,greedy-cycle,N2,60,11876,15476,27352,70
kroA100.tsp,greedy-ls,greedy-cycle,N1,79,15489,12386,27875,28
kroB100.tsp,greedy-ls,greedy-cycle,N1,94,10827,16739,27566,15
kroB100.tsp,steepest-ls,random-walk,N2,99,14709,13472,28181,316
kroB100.tsp,greedy-ls,random-walk,N2,24,13041,12802,25843,284
kroB100.tsp,steepest-ls,random-walk,N1,66,23327,18692,42019,474
kroA100.tsp,greedy-ls,greedy-cycle,N2,86,11509,14263,25772,43
kroB100.tsp,steepest-ls,greedy-cycle,N2,56,10344,13876,24220,218
kroA100.tsp,greedy-ls,greedy-cycle,N2,69,11502,14991,26493,55
kroA100.tsp,steepest-ls,greedy-cycle,N1,70,15486,12386,27872,49
kroB100.tsp,steepest-ls,random-walk,N1,89,15809,20041,35850,539
kroB100.tsp,greedy-ls,greedy-cycle,N2,84,10837,15555,26392,105
kroA100.tsp,greedy-ls,random-walk,N2,72,14180,11045,25225,210
kroB100.tsp,steepest-ls,greedy-cycle,N2,7,10837,15384,26221,66
kroA100.tsp,steepest-ls,random-walk,N1,85,20328,18434,38762,440
kroB100.tsp,steepest-ls,greedy-cycle,N2,21,11506,14572,26078,57
kroB100.tsp,greedy-ls,random-walk,N2,53,16858,11844,28702,204
kroB100.tsp,steepest-ls,random-walk,N1,11,27521,19417,46938,337
kroA100.tsp,steepest-ls,greedy-cycle,N2,17,14428,11657,26085,102
kroA100.tsp,greedy-ls,random-walk,N1,62,20030,18474,38504,298
kroA100.tsp,steepest-ls,random-walk,N2,95,15615,11457,27072,491
kroB100.tsp,steepest-ls,greedy-cycle,N1,31,14408,10577,24985,96
kroB100.tsp,greedy-ls,random-walk,N1,43,17269,20776,38045,287
kroB100.tsp,steepest-ls,greedy-cycle,N2,99,11194,14354,25548,80
kroA100.tsp,greedy-ls,random-walk,N2,25,14414,11591,26005,243
kroA100.tsp,greedy-ls,greedy-cycle,N2,49,15513,12386,27899,61
kroA100.tsp,steepest-ls,greedy-cycle,N1,50,11600,14330,25930,68
kroB100.tsp,steepest-ls,random-walk,N1,46,24508,18646,43154,1274
kroB100.tsp,greedy-ls,greedy-cycle,N1,82,14899,10763,25662,392
kroB100.tsp,steepest-ls,greedy-cycle,N2,76,11194,14354,25548,124
kroA100.tsp,greedy-ls,random-walk,N2,7,13976,12406,26382,231
kroB100.tsp,steepest-ls,greedy-cycle,N1,89,12450,13865,26315,129
kroB100.tsp,greedy-ls,greedy-cycle,N2,2,14317,10353,24670,26
kroA100.tsp,greedy-ls,random-walk,N1,35,20447,18328,38775,288
kroA100.tsp,steepest-ls,greedy-cycle,N2,40,11502,14991,26493,65
kroA100.tsp,greedy-ls,greedy-cycle,N1,59,14595,11657,26252,30
kroB100.tsp,steepest-ls,random-walk,N2,56,14477,13281,27758,314
kroB100.tsp,greedy-ls,random-walk,N1,14,18115,21962,40077,277
kroB100.tsp,steepest-ls,greedy-cycle,N1,66,12376,13854,26230,199
kroA100.tsp,steepest-ls,greedy-cycle,N1,2,11600,14330,25930,90
kroA100.tsp,steepest-ls,greedy-cycle,N1,46,12386,15198,27584,49
kroA100.tsp,greedy-ls,random-walk,N2,33,15553,10829,26382,308
kroB100.tsp,steepest-ls,greedy-cycle,N2,60,12450,13601,26051,125
kroB100.tsp,greedy-ls,greedy-cycle,N1,94,10827,16739,27566,139
kroB100.tsp,greedy-ls,random-walk,N2,12,16202,14036,30238,196
kroB100.tsp,steepest-ls,random-walk,N1,50,23410,20170,43580,353
kroA100.tsp,steepest-ls,greedy-cycle,N2,56,15198,12386,27584,44
kroA100.tsp,greedy-ls,random-walk,N1,23,26018,17696,43714,1508
kroB100.tsp,steepest-ls,greedy-cycle,N1,70,10342,16742,27084,62
kroB100.tsp,steepest-ls,random-walk,N2,40,15529,13579,29108,528
kroA100.tsp,steepest-ls,random-walk,N1,93,20898,19833,40731,387
kroA100.tsp,greedy-ls,random-walk,N2,64,17016,14651,31667,363
kroA100.tsp,steepest-ls,greedy-cycle,N1,11,14770,11657,26427,40
kroB100.tsp,greedy-ls,random-walk,N2,45,15584,13364,28948,458
kroB100.tsp,steepest-ls,greedy-cycle,N2,37,10628,17104,27732,42
kroA100.tsp,steepest-ls,random-walk,N2,83,13943,12458,26401,325
kroA100.tsp,greedy-ls,random-walk,N1,74,22409,15115,37524,574
kroA100.tsp,greedy-ls,greedy-cycle,N1,18,14595,11657,26252,31
kroB100.tsp,steepest-ls,random-walk,N2,17,14257,13810,28067,944
kroB100.tsp,greedy-ls,random-walk,N1,55,18404,20270,38674,514
kroB100.tsp,steepest-ls,greedy-cycle,N1,27,10827,16739,27566,24
kroB100.tsp,greedy-ls,greedy-cycle,N2,71,11194,14653,25847,48
kroA100.tsp,steepest-ls,greedy-cycle,N1,85,11502,15434,26936,46
kroB100.tsp,greedy-ls,greedy-cycle,N1,57,10827,16739,27566,129
kroA100.tsp,greedy-ls,greedy-cycle,N2,73,11600,14076,25676,96
kroB100.tsp,steepest-ls,random-walk,N1,93,26046,16371,42417,554
kroB100.tsp,greedy-ls,greedy-cycle,N1,61,10827,16739,27566,13
kroA100.tsp,steepest-ls,greedy-cycle,N2,95,11657,14435,26092,37
kroA100.tsp,steepest-ls,random-walk,N2,17,14956,10123,25079,410
kroA100.tsp,greedy-ls,greedy-cycle,N1,63,14698,11657,26355,16
kroB100.tsp,steepest-ls,random-walk,N2,83,15649,12761,28410,407
kroA100.tsp,steepest-ls,random-walk,N1,50,23048,22756,45804,393
kroA100.tsp,steepest-ls,random-walk,N2,9,15349,11405,26754,282
kroB100.tsp,greedy-ls,greedy-cycle,N2,26,10344,13763,24107,46
kroB100.tsp,greedy-ls,random-walk,N2,69,14330,10265,24595,1248
kroB100.tsp,greedy-ls,random-walk,N2,86,15841,13640,29481,257
kroA100.tsp,greedy-ls,greedy-cycle,N2,24,14147,11657,25804,26
kroB100.tsp,greedy-ls,greedy-cycle,N1,8,11194,15678,26872,370
kroB100.tsp,greedy-ls,random-walk,N2,5,16283,11369,27652,195
kroA100.tsp,greedy-ls,random-walk,N2,48,16889,11452,28341,734
kroA100.tsp,steepest-ls,random-walk,N2,40,15123,10824,25947,322
kroB100.tsp,greedy-ls,random-walk,N1,79,18464,17782,36246,266
kroB100.tsp,greedy-ls,greedy-cycle,N1,36,16692,10859,27551,20
kroB100.tsp,greedy-ls,random-walk,N1,96,22425,18371,40796,225
kroA100.tsp,greedy-ls,greedy-cycle,N1,34,11669,16156,27825,29
kroA100.tsp,greedy-ls,random-walk,N1,58,21816,23110,44926,366
kroB100.tsp,greedy-ls,greedy-cycle,N2,30,11061,15324,26385,31
kroA100.tsp,steepest-ls,random-walk,N1,46,18810,18154,36964,789
kroB100.tsp,greedy-ls,greedy-cycle,N1,16,14591,11305,25896,163
kroA100.tsp,greedy-ls,greedy-cycle,N2,32,14157,11657,25814,22
kroB100.tsp,greedy-ls,random-walk,N2,90,14205,11770,25975,197
kroB100.tsp,steepest-ls,greedy-cycle,N1,2,15054,10577,25631,150
kroB100.tsp,greedy-ls,greedy-cycle,N1,20,11027,15534,26561,43
kroA100.tsp,steepest-ls,random-walk,N2,56,13809,12661,26470,349
kroA100.tsp,greedy-ls,greedy-cycle,N1,22,15489,12386,27875,31
kroB100.tsp,greedy-ls,random-walk,N1,80,20346,19297,39643,241
kroA100.tsp,steepest-ls,random-walk,N1,11,25678,21977,47655,506
kroA100.tsp,steepest-ls,greedy-cycle,N1,93,12027,13870,25897,25
kroA100.tsp,greedy-ls,random-walk,N1,2,18695,18893,37588,847
kroB100.tsp,greedy-ls,greedy-cycle,N2,67,10099,16651,26750,21
kroB100.tsp,greedy-ls,greedy-cycle,N1,7,10837,16765,27602,21
kroB100.tsp,greedy-ls,random-walk,N2,28,16148,14166,30314,246
kroB100.tsp,greedy-ls,greedy-cycle,N2,88,14826,11907,26733,85
kroB100.tsp,steepest-ls,random-walk,N1,85,22597,16519,39116,534
kroA100.tsp,greedy-ls,greedy-cycle,N2,65,15198,12386,27584,22
kroA100.tsp,steepest-ls,greedy-cycle,N2,7,11713,14957,26670,68
kroB100.tsp,greedy-ls,greedy-cycle,N1,41,16479,10859,27338,247
kroA100.tsp,steepest-ls,greedy-cycle,N2,83,11713,14957,26670,730
kroB100.tsp,greedy-ls,random-walk,N1,38,24519,24267,48786,399
kroB100.tsp,greedy-ls,greedy-cycle,N1,77,15739,11305,27044,32
kroB100.tsp,steepest-ls,random-walk,N2,95,14720,13983,28703,390
kroB100.tsp,greedy-ls,greedy-cycle,N1,98,11194,15678,26872,19
kroA100.tsp,greedy-ls,greedy-cycle,N1,75,15198,12386,27584,18
kroA100.tsp,greedy-ls,random-walk,N1,19,20408,19990,40398,358
kroB100.tsp,steepest-ls,greedy-cycle,N2,51,14317,10353,24670,91
kroB100.tsp,greedy-ls,random-walk,N2,23,16634,13232,29866,198
kroB100.tsp,steepest-ls,random-walk,N1,61,27857,16459,44316,946
kroA100.tsp,greedy-ls,greedy-cycle,N2,81,11698,15248,26946,51
kroA100.tsp,steepest-ls,greedy-cycle,N1,98,14763,11657,26420,44
kroA100.tsp,greedy-ls,random-walk,N1,9,21664,19231,40895,301
kroA100.tsp,steepest-ls,greedy-cycle,N1,77,11915,15550,27465,49
kroB100.tsp,greedy-ls,greedy-cycle,N2,83,14317,10209,24526,29
kroB100.tsp,steepest-ls,greedy-cycle,N1,41,16692,10859,27551,162
kroB100.tsp,steepest-ls,random-walk,N2,71,15685,11578,27263,455
kroB100.tsp,greedy-ls,random-walk,N1,33,24708,16069,40777,685
kroA100.tsp,greedy-ls,greedy-cycle,N2,4,15198,12386,27584,21
kroA100.tsp,steepest-ls,greedy-cycle,N2,88,15486,12386,27872,193
kroA100.tsp,greedy-ls,greedy-cycle,N1,91,14575,11657,26232,22
kroA100.tsp,steepest-ls,greedy-cycle,N2,67,13353,12498,25851,82
kroB100.tsp,greedy-ls,greedy-cycle,N1,93,11119,15138,26257,29
kroA100.tsp,greedy-ls,random-walk,N1,12,19595,21601,41196,528
kroB100.tsp,greedy-ls,random-walk,N2,74,15908,11313,27221,234
kroB100.tsp,steepest-ls,random-walk,N1,36,23578,18694,42272,768
kroA100.tsp,greedy-ls,random-walk,N2,55,15727,11076,26803,505
kroA100.tsp,steepest-ls,greedy-cycle,N1,20,11713,15934,27647,57
kroA100.tsp,greedy-ls,greedy-cycle,N2,39,12333,15110,27443,28
kroB100.tsp,steepest-ls,greedy-cycle,N1,9,10827,16739,27566,22
kroB100.tsp,steepest-ls,random-walk,N2,26,15664,13228,28892,327
kroB100.tsp,greedy-ls,random-walk,N1,64,24496,13668,38164,251
kroB100.tsp,steepest-ls,greedy-cycle,N1,16,15576,11305,26881,52
kroA100.tsp,greedy-ls,random-walk,N1,45,24290,20502,44792,1058
kroA100.tsp,greedy-ls,greedy-cycle,N1,29,12386,15198,27584,30
kroA100.tsp,steepest-ls,greedy-cycle,N2,30,12333,15083,27416,117
kroA100.tsp,steepest-ls,random-walk,N2,2,14208,10713,24921,402
kroB100.tsp,steepest-ls,greedy-cycle,N2,10,10896,15873,26769,72
kroB100.tsp,greedy-ls,random-walk,N2,62,14757,13367,28124,254
kroB100.tsp,steepest-ls,random-walk,N1,20,22764,18710,41474,454
kroA100.tsp,steepest-ls,greedy-cycle,N1,36,14581,11657,26238,36
kroB100.tsp,greedy-ls,greedy-cycle,N1,3,11108,15138,26246,95
kroA100.tsp,greedy-ls,random-walk,N2,43,16473,10196,26669,980
kroB100.tsp,steepest-ls,random-walk,N2,30,13188,11431,24619,484
kroB100.tsp,greedy-ls,random-walk,N1,72,20719,17295,38014,217
kroA100.tsp,steepest-ls,greedy-cycle,N2,26,15198,12386,27584,64
kroA100.tsp,greedy-ls,random-walk,N1,53,23893,20623,44516,249
kroA100.tsp,greedy-ls,greedy-cycle,N2,97,15198,12386,27584,18
kroB100.tsp,greedy-ls,random-walk,N2,35,15401,12169,27570,246
kroB100.tsp,steepest-ls,random-walk,N1,77,24543,21548,46091,445
kroB100.tsp,steepest-ls,greedy-cycle,N2,47,11505,16324,27829,209
kroA100.tsp,greedy-ls,random-walk,N2,14,16176,10534,26710,216
kroB100.tsp,steepest-ls,random-walk,N1,98,23905,18747,42652,604
kroB100.tsp,greedy-ls,greedy-cycle,N2,95,12068,15082,27150,41
kroA100.tsp,greedy-ls,greedy-cycle,N2,78,11696,15929,27625,28
kroA100.tsp,steepest-ls,greedy-cycle,N1,61,11698,15934,27632,44
kroA100.tsp,greedy-ls,greedy-cycle,N1,87,12412,13799,26211,58
kroB100.tsp,steepest-ls,random-walk,N2,67,17451,12102,29553,324
kroB100.tsp,greedy-ls,random-walk,N1,25,20981,17272,38253,244
kroB100.tsp,steepest-ls,greedy-cycle,N1,57,10827,16739,27566,20
kroB100.tsp,greedy-ls,greedy-cycle,N1,85,11119,15138,26257,37
kroB100.tsp,steepest-ls,random-walk,N2,88,14372,12874,27246,524
kroA100.tsp,steepest-ls,greedy-cycle,N2,71,12386,15198,27584,71
kroA100.tsp,greedy-ls,greedy-cycle,N1,68,12220,14218,26438,39
kroB100.tsp,greedy-ls,greedy-cycle,N1,27,10827,16739,27566,141
kroA100.tsp,steepest-ls,random-walk,N1,98,17613,19222,36835,811
kroA100.tsp,steepest-ls,random-walk,N1,77,23549,20816,44365,323
kroA100.tsp,greedy-ls,random-walk,N2,80,15729,10149,25878,1252
kroA100.tsp,steepest-ls,random-walk,N2,88,14539,14870,29409,315
kroA100.tsp,steepest-ls,random-walk,N1,7,23212,19604,42816,1569
kroA100.tsp,greedy-ls,greedy-cycle,N1,13,11657,14581,26238,29
kroB100.tsp,steepest-ls,random-walk,N1,5,22285,20236,42521,754
kroB100.tsp,greedy-ls,greedy-cycle,N1,11,11119,15138,26257,11
kroA100.tsp,steepest-ls,random-walk,N2,67,14112,13596,27708,331
kroA100.tsp,greedy-ls,random-walk,N1,90,21109,24915,46024,238
kroA100.tsp,greedy-ls,greedy-cycle,N2,54,11502,15216,26718,36
kroB100.tsp,steepest-ls,greedy-cycle,N2,84,10837,15384,26221,141
kroB100.tsp,greedy-ls,greedy-cycle,N1,70,10342,16629,26971,194
kroA100.tsp,greedy-ls,random-walk,N2,38,15665,11639,27304,240
kroA100.tsp,steepest-ls,random-walk,N1,20,17812,20989,38801,529
kroB100.tsp,greedy-ls,greedy-cycle,N2,56,10344,14008,24352,107
kroB100.tsp,greedy-ls,random-walk,N2,19,15096,14194,29290,206
kroA100.tsp,greedy-ls,greedy-cycle,N1,44,11502,15415,26917,25
kroB100.tsp,steepest-ls,greedy-cycle,N1,94,10827,16739,27566,25
kroA100.tsp,greedy-ls,random-walk,N1,28,20405,23273,43678,245
kroA100.tsp,steepest-ls,random-walk,N2,30,14273,12410,26683,354
kroB100.tsp,greedy-ls,greedy-cycle,N1,46,10827,16739,27566,8
kroB100.tsp,greedy-ls,greedy-cycle,N1,66,12463,13781,26244,665
kroA100.tsp,greedy-ls,greedy-cycle,N1,1,12532,11708,24240,139
kroB100.tsp,steepest-ls,greedy-cycle,N2,92,14206,11305,25511,150
kroA100.tsp,greedy-ls,greedy-cycle,N2,42,13485,12074,25559,27
kroB100.tsp,greedy-ls,greedy-cycle,N2,40,9963,16538,26501,21
kroA100.tsp,steepest-ls,random-walk,N1,36,24412,23448,47860,770
kroB100.tsp,greedy-ls,greedy-cycle,N1,89,12440,14345,26785,600
kroB100.tsp,greedy-ls,greedy-cycle,N2,9,10827,15593,26420,25
kroB100.tsp,steepest-ls,greedy-cycle,N1,82,14899,10763,25662,79
kroA100.tsp,greedy-ls,greedy-cycle,N1,52,11502,15436,26938,110
kroB100.tsp,greedy-ls,greedy-cycle,N1,50,15368,11585,26953,28
kroA100.tsp,steepest-ls,random-walk,N2,26,13598,12968,26566,362
kroA100.tsp,steepest-ls,greedy-cycle,N1,9,11713,15934,27647,71
kroA100.tsp,greedy-ls,greedy-cycle,N2,15,14164,11657,25821,28
kroB100.tsp,greedy-ls,greedy-cycle,N1,31,13432,10951,24383,390
kroA100.tsp,greedy-ls,random-walk,N2,79,15157,11756,26913,226
kroA100.tsp,greedy-ls,random-walk,N2,96,17268,13186,30454,239
kroA100.tsp,steepest-ls,random-walk,N1,61,28079,20895,48974,382
kroB100.tsp,greedy-ls,greedy-cycle,N2,17,15539,10859,26398,28
kroB100.tsp,greedy-ls,random-walk,N2,58,17291,13496,30787,374
kroA100.tsp,greedy-ls,random-walk,N1,69,25774,17680,43454,214
kroA100.tsp,greedy-ls,random-walk,N1,86,23352,21556,44908,747
kroA100.tsp,steepest-ls,random-walk,N2,71,14837,11303,26140,344
kroB100.tsp,greedy-ls,random-walk,N1,48,20088,18617,38705,245
kroA100.tsp,steepest-ls,greedy-cycle,N2,84,14435,11657,26092,171
kroB100.tsp,greedy-ls,greedy-cycle,N1,70,10629,16629,27258,19
kroA100.tsp,greedy-ls,greedy-cycle,N2,8,14813,12784,27597,15
kroB100.tsp,steepest-ls,random-walk,N2,92,14990,13200,28190,352
kroA100.tsp,greedy-ls,greedy-cycle,N1,72,14581,11657,26238,36
kroA100.tsp,greedy-ls,random-walk,N1,5,24833,19769,44602,508
kroA100.tsp,steepest-ls,greedy-cycle,N1,94,15486,12386,27872,51
kroB100.tsp,greedy-ls,greedy-cycle,N2,60,12359,13601,25960,104
kroA100.tsp,steepest-ls,random-walk,N1,16,19257,17651,36908,412
kroB100.tsp,greedy-ls,greedy-cycle,N1,46,10827,16739,27566,124
kroB100.tsp,steepest-ls,random-walk,N1,82,19090,15629,34719,508
kroA100.tsp,greedy-ls,greedy-cycle,N2,62,11762,15533,27295,51
kroA100.tsp,steepest-ls,random-walk,N2,51,14500,13204,27704,336
kroB100.tsp,greedy-ls,random-walk,N1,68,17781,21584,39365,230
kroB100.tsp,steepest-ls,greedy-cycle,N1,5,10288,16742,27030,75
kroB100.tsp,greedy-ls,greedy-cycle,N1,27,10827,16739,27566,9
kroA100.tsp,greedy-ls,greedy-cycle,N1,25,11551,14049,25600,58
kroB100.tsp,greedy-ls,random-walk,N1,87,22661,16292,38953,222
kroA100.tsp,greedy-ls,random-walk,N1,49,18934,18857,37791,245
kroA100.tsp,steepest-ls,random-walk,N1,41,26632,21496,48128,476
kroB100.tsp,greedy-ls,greedy-cycle,N2,37,11070,17105,28175,25
kroB100.tsp,greedy-ls,random-walk,N2,78,13872,13662,27534,185
kroA100.tsp,greedy-ls,greedy-cycle,N2,35,11429,14017,25446,40
kroB100.tsp,greedy-ls,random-walk,N2,97,16067,13149,29216,676
kroB100.tsp,greedy-ls,greedy-cycle,N1,11,11108,15138,26246,180
kroA100.tsp,greedy-ls,random-walk,N2,59,16381,10858,27239,305
kroB100.tsp,greedy-ls,greedy-cycle,N1,31,14408,10762,25170,31
kroA100.tsp,steepest-ls,random-walk,N2,47,17138,10464,27602,326
kroB100.tsp,greedy-ls,random-walk,N1,91,19431,22237,41668,190
kroA100.tsp,greedy-ls,greedy-cycle,N1,33,11657,14581,26238,18
kroA100.tsp,steepest-ls,greedy-cycle,N1,100,12386,15198,27584,58
kroB100.tsp,greedy-ls,greedy-cycle,N2,21,11658,14759,26417,35
kroA100.tsp,steepest-ls,random-walk,N1,57,22725,20771,43496,392
kroB100.tsp,greedy-ls,random-walk,N2,2,16933,11202,28135,214
kroB100.tsp,greedy-ls,random-walk,N2,81,14830,12052,26882,308
kroA100.tsp,greedy-ls,greedy-cycle,N2,23,14435,11657,26092,23
kroA100.tsp,steepest-ls,random-walk,N2,10,14076,11816,25892,346
kroB100.tsp,greedy-ls,random-walk,N1,29,29230,20337,49567,304
kroB100.tsp,greedy-ls,greedy-cycle,N1,66,12194,14044,26238,33
kroA100.tsp,steepest-ls,greedy-cycle,N2,92,11860,10969,22829,139
kroA100.tsp,greedy-ls,greedy-cycle,N1,64,11625,16077,27702,35
kroB100.tsp,steepest-ls,random-walk,N2,84,15969,10843,26812,664
kroB100.tsp,greedy-ls,greedy-cycle,N1,89,12268,13868,26136,33
kroB100.tsp,greedy-ls,greedy-cycle,N2,76,11194,14445,25639,44
kroB100.tsp,greedy-ls,random-walk,N2,39,16056,13739,29795,280
kroA100.tsp,steepest-ls,greedy-cycle,N1,82,11657,14581,26238,56
kroA100.tsp,greedy-ls,greedy-cycle,N2,74,14178,11657,25835,41
kroB100.tsp,greedy-ls,greedy-cycle,N2,99,11194,14445,25639,42
kroB100.tsp,steepest-ls,random-walk,N1,94,24590,18711,43301,513
kroB100.tsp,greedy-ls,greedy-cycle,N1,50,15304,11807,27111,299
kroA100.tsp,greedy-ls,random-walk,N2,18,15763,13154,28917,255
kroA100.tsp,steepest-ls,random-walk,N2,84,14917,12334,27251,338
kroA100.tsp,greedy-ls,random-walk,N1,73,26431,22647,49078,403
kroB100.tsp,steepest-ls,greedy-cycle,N1,20,11027,15534,26561,74
kroB100.tsp,greedy-ls,random-walk,N1,7,19261,20347,39608,445
kroB100.tsp,steepest-ls,random-walk,N2,10,17424,11324,28748,600
kroB100.tsp,greedy-ls,random-walk,N1,52,17662,17582,35244,312
kroB100.tsp,steepest-ls,random-walk,N1,9,24730,18487,43217,516
kroA100.tsp,steepest-ls,greedy-cycle,N1,16,15486,12386,27872,52
kroA100.tsp,steepest-ls,random-walk,N1,94,25021,24523,49544,478
kroA100.tsp,greedy-ls,random-walk,N2,63,15177,12023,27200,277
kroB100.tsp,steepest-ls,greedy-cycle,N2,30,10838,15443,26281,60
kroB100.tsp,greedy-ls,random-walk,N2,42,15172,14869,30041,176
kroA100.tsp,greedy-ls,random-walk,N1,24,22098,21448,43546,632
kroB100.tsp,steepest-ls,greedy-cycle,N1,98,11205,15678,26883,75
kroA100.tsp,steepest-ls,greedy-cycle,N2,51,11698,14957,26655,55
kroA100.tsp,greedy-ls,greedy-cycle,N1,48,12386,15198,27584,34
kroB100.tsp,steepest-ls,random-walk,N2,47,15867,14079,29946,721
kroB100.tsp,steepest-ls,greedy-cycle,N1,77,15576,11305,26881,96
kroA100.tsp,greedy-ls,random-walk,N2,34,15017,10451,25468,331
kroB100.tsp,steepest-ls,greedy-cycle,N2,88,14968,11907,26875,118
kroA100.tsp,greedy-ls,greedy-cycle,N2,58,11674,15518,27192,36
kroA100.tsp,steepest-ls,greedy-cycle,N1,41,12386,15198,27584,68
kroB100.tsp,greedy-ls,random-walk,N2,15,17434,11026,28460,204
kroB100.tsp,steepest-ls,random-walk,N1,57,22720,14947,37667,477
kroB100.tsp,steepest-ls,greedy-cycle,N2,67,10099,16651,26750,23
kroB100.tsp,greedy-ls,greedy-cycle,N1,93,11119,15138,26257,165
kroA100.tsp,steepest-ls,greedy-cycle,N2,47,14139,11657,25796,69
kroA100.tsp,greedy-ls,random-walk,N1,32,19679,21969,41648,295
kroB100.tsp,greedy-ls,greedy-cycle,N2,5,10099,16651,26750,10
kroA100.tsp,steepest-ls,greedy-cycle,N1,5,11502,15434,26936,61
kroB100.tsp,steepest-ls,greedy-cycle,N1,61,10827,16739,27566,28
kroB100.tsp,steepest-ls,random-walk,N2,51,17652,10861,28513,618
kroB100.tsp,greedy-ls,random-walk,N1,13,23706,16882,40588,337
kroA100.tsp,steepest-ls,greedy-cycle,N1,57,11713,15934,27647,54
kroA100.tsp,greedy-ls,random-walk,N2,22,17440,11705,29145,230
kroB100.tsp,greedy-ls,greedy-cycle,N1,85,11108,15138,26246,216
kroB100.tsp,steepest-ls,greedy-cycle,N2,71,11194,14354,25548,99
kroB100.tsp,steepest-ls,random-walk,N1,41,18907,14292,33199,2089
kroA100.tsp,greedy-ls,random-walk,N1,65,27909,21185,49094,232
kroA100.tsp,steepest-ls,random-walk,N2,92,15368,9704,25072,308
kroA100.tsp,steepest-ls,greedy-cycle,N2,10,14147,11657,25804,52
kroB100.tsp,greedy-ls,random-walk,N1,44,22784,16030,38814,221
kroB100.tsp,steepest-ls,greedy-cycle,N1,36,16692,10859,27551,76
kroA100.tsp,greedy-ls,random-walk,N2,75,15511,12809,28320,252
kroA100.tsp,steepest-ls,random-walk,N1,82,23699,18437,42136,514
kroA100.tsp,greedy-ls,greedy-cycle,N2,19,15198,12386,27584,22
kroB100.tsp,greedy-ls,random-walk,N2,54,17071,11957,29028,247
kroB100.tsp,steepest-ls,random-walk,N1,16,22238,17839,40077,505
kroB100.tsp,steepest-ls,greedy-cycle,N2,26,10344,13876,24220,60
kroA100.tsp,greedy-ls,random-walk,N2,74,17827,12937,30764,283
kroB100.tsp,steepest-ls,greedy-cycle,N2,1,11506,14572,26078,104
kroA100.tsp,steepest-ls,random-walk,N1,83,21009,20476,41485,332
kroA100.tsp,greedy-ls,greedy-cycle,N2,18,13959,11657,25616,28
kroB100.tsp,greedy-ls,random-walk,N2,55,15958,10605,26563,686
kroB100.tsp,steepest-ls,random-walk,N1,17,23360,20949,44309,499
kroB100.tsp,steepest-ls,greedy-cycle,N2,27,10827,15415,26242,45
kroA100.tsp,greedy-ls,random-walk,N1,64,21507,21116,42623,345
kroA100.tsp,steepest-ls,random-walk,N2,93,15498,12190,27688,280
kroA100.tsp,steepest-ls,greedy-cycle,N2,11,14435,11657,26092,75
kroB100.tsp,greedy-ls,random-walk,N1,45,17320,22693,40013,231
kroB100.tsp,steepest-ls,greedy-cycle,N1,37,11316,17195,28511,51
kroA100.tsp,steepest-ls,greedy-cycle,N1,56,15198,12386,27584,47
kroA100.tsp,greedy-ls,random-walk,N2,23,16711,12303,29014,239
kroB100.tsp,greedy-ls,greedy-cycle,N1,84,10826,16765,27591,124
kroB100.tsp,steepest-ls,greedy-cycle,N2,70,10153,16651,26804,32
kroB100.tsp,steepest-ls,random-walk,N1,40,20210,26994,47204,1002
kroA100.tsp,steepest-ls,greedy-cycle,N2,46,12386,15198,27584,106
kroA100.tsp,greedy-ls,random-walk,N2,1,15311,10949,26260,200
kroB100.tsp,greedy-ls,greedy-cycle,N2,4,14204,10648,24852,32
kroA100.tsp,greedy-ls,random-walk,N1,33,21168,18294,39462,789
kroA100.tsp,steepest-ls,greedy-cycle,N1,4,15198,12386,27584,60
kroB100.tsp,steepest-ls,greedy-cycle,N1,60,12450,13865,26315,240
kroB100.tsp,steepest-ls,random-walk,N2,50,14756,12074,26830,380
kroB100.tsp,greedy-ls,random-walk,N1,12,21643,16001,37644,293
kroA100.tsp,greedy-ls,random-walk,N2,35,16197,12439,28636,317
kroB100.tsp,steepest-ls,greedy-cycle,N2,89,12450,13601,26051,291
kroA100.tsp,steepest-ls,greedy-cycle,N1,40,11600,14330,25930,393
kroA100.tsp,greedy-ls,greedy-cycle,N2,59,14196,11657,25853,28
kroB100.tsp,greedy-ls,random-walk,N2,14,17502,12678,30180,190
kroB100.tsp,steepest-ls,random-walk,N1,56,21030,17142,38172,592
kroB100.tsp,steepest-ls,greedy-cycle,N2,66,12405,13081,25486,104
kroB100.tsp,greedy-ls,greedy-cycle,N1,92,15684,11867,27551,168
kroA100.tsp,greedy-ls,random-walk,N1,25,23671,18011,41682,421
kroB100.tsp,steepest-ls,greedy-cycle,N1,99,11205,15678,26883,93
kroA100.tsp,greedy-ls,greedy-cycle,N1,49,15513,12386,27899,67
kroA100.tsp,steepest-ls,greedy-cycle,N2,50,11502,14991,26493,51
kroB100.tsp,steepest-ls,random-walk,N2,46,14406,13047,27453,429
kroB100.tsp,steepest-ls,greedy-cycle,N1,76,11205,15678,26883,86
kroA100.tsp,steepest-ls,greedy-cycle,N1,17,14763,11657,26420,36
kroA100.tsp,steepest-ls,random-walk,N1,95,21910,19162,41072,479
kroA100.tsp,greedy-ls,random-walk,N2,62,14308,12485,26793,298
kroB100.tsp,steepest-ls,greedy-cycle,N2,31,14317,10353,24670,45
kroB100.tsp,greedy-ls,random-walk,N2,43,14109,14412,28521,191
kroA100.tsp,steepest-ls,random-walk,N2,85,16664,12159,28823,309
kroA100.tsp,greedy-ls,random-walk,N1,72,22459,14923,37382,1345
kroB100.tsp,steepest-ls,greedy-cycle,N1,21,12212,15896,28108,64
kroB100.tsp,steepest-ls,random-walk,N2,11,15842,11012,26854,417
kroB100.tsp,greedy-ls,random-walk,N1,53,25633,16552,42185,321
kroB100.tsp,greedy-ls,random-walk,N1,6,21744,20849,42593,363
kroB100.tsp,steepest-ls,random-walk,N1,8,24487,18307,42794,701
kroA100.tsp,steepest-ls,random-walk,N1,100,25641,15066,40707,399
kroB100.tsp,greedy-ls,greedy-cycle,N2,77,14016,11222,25238,51
kroB100.tsp,greedy-ls,random-walk,N2,38,18571,12778,31349,349
kroA100.tsp,steepest-ls,greedy-cycle,N1,83,11713,15934,27647,49
kroA100.tsp,greedy-ls,greedy-cycle,N2,75,15198,12386,27584,24
kroB100.tsp,greedy-ls,greedy-cycle,N2,98,11194,14664,25858,45
kroB100.tsp,steepest-ls,random-walk,N1,95,22573,19495,42068,621
kroB100.tsp,greedy-ls,greedy-cycle,N1,51,14295,10763,25058,286
kroA100.tsp,greedy-ls,random-walk,N2,19,14274,11208,25482,232
kroA100.tsp,steepest-ls,random-walk,N2,11,17769,11411,29180,350
kroB100.tsp,greedy-ls,random-walk,N1,28,23446,15407,38853,549
kroB100.tsp,greedy-ls,greedy-cycle,N1,67,10288,16742,27030,21
kroA100.tsp,steepest-ls,greedy-cycle,N2,93,12016,13870,25886,23
kroA100.tsp,greedy-ls,greedy-cycle,N1,65,15198,12386,27584,26
kroB100.tsp,steepest-ls,random-walk,N2,85,16011,12156,28167,451
kroB100.tsp,greedy-ls,greedy-cycle,N1,88,15301,11907,27208,42
kroA100.tsp,greedy-ls,random-walk,N2,100,15150,11022,26172,234
kroB100.tsp,greedy-ls,greedy-cycle,N2,20,10838,15443,26281,27
kroA100.tsp,steepest-ls,random-walk,N1,56,21245,15454,36699,379
kroB100.tsp,greedy-ls,random-walk,N2,3,15653,14726,30379,197
kroB100.tsp,greedy-ls,random-walk,N2,80,14909,11164,26073,389
kroA100.tsp,greedy-ls,greedy-cycle,N2,22,15489,12386,27875,26
kroB100.tsp,greedy-ls,greedy-cycle,N1,30,11027,15534,26561,46
kroA100.tsp,steepest-ls,random-walk,N2,46,14078,11479,25557,383
kroB100.tsp,greedy-ls,random-walk,N1,90,19703,14310,34013,249
kroA100.tsp,greedy-ls,greedy-cycle,N1,32,14623,11657,26280,20
kroA100.tsp,steepest-ls,random-walk,N1,40,31481,15912,47393,397
kroB100.tsp,greedy-ls,greedy-cycle,N2,36,14973,10859,25832,46
kroB100.tsp,greedy-ls,random-walk,N2,79,13970,12045,26015,263
kroA100.tsp,greedy-ls,greedy-cycle,N2,34,11713,15542,27255,34
kroB100.tsp,greedy-ls,random-walk,N2,96,16613,12908,29521,208
kroB100.tsp,greedy-ls,greedy-cycle,N1,100,10554,14799,25353,394
kroB100.tsp,greedy-ls,greedy-cycle,N1,10,11909,16336,28245,331
kroA100.tsp,greedy-ls,random-walk,N2,58,16928,12328,29256,1606
kroA100.tsp,steepest-ls,random-walk,N2,50,14734,11870,26604,313
kroB100.tsp,greedy-ls,random-walk,N1,69,21139,19069,40208,244
kroB100.tsp,steepest-ls,greedy-cycle,N1,4,14317,10763,25080,115
kroB100.tsp,greedy-ls,greedy-cycle,N1,26,10565,15349,25914,39
kroA100.tsp,greedy-ls,greedy-cycle,N1,24,14595,11657,26252,29
kroB100.tsp,greedy-ls,random-walk,N1,86,23072,19431,42503,217
kroA100.tsp,greedy-ls,random-walk,N1,48,24898,21083,45981,503
kroA100.tsp,greedy-ls,random-walk,N1,4,20091,19085,39176,338
kroA100.tsp,steepest-ls,greedy-cycle,N1,95,11657,14581,26238,43
kroB100.tsp,greedy-ls,greedy-cycle,N1,1,12220,15905,28125,19
kroB100.tsp,greedy-ls,greedy-cycle,N2,61,10827,15415,26242,20
kroA100.tsp,steepest-ls,random-walk,N1,17,22743,15387,38130,384
kroB100.tsp,greedy-ls,greedy-cycle,N1,47,11659,16833,28492,343
kroB100.tsp,steepest-ls,random-walk,N1,83,19637,17507,37144,467
kroA100.tsp,greedy-ls,greedy-cycle,N2,63,14182,11657,25839,27
kroA100.tsp,steepest-ls,greedy-cycle,N2,1,12532,10932,23464,99
kroA100.tsp,steepest-ls,greedy-cycle,N2,85,11502,14424,25926,234
kroB100.tsp,greedy-ls,greedy-cycle,N1,71,11261,15678,26939,23
kroA100.tsp,greedy-ls,greedy-cycle,N2,9,11889,14900,26789,26
kroB100.tsp,steepest-ls,random-walk,N2,93,16712,10624,27336,370
kroA100.tsp,greedy-ls,greedy-cycle,N1,73,11600,14330,25930,62
kroA100.tsp,greedy-ls,random-walk,N1,68,21125,15406,36531,277
kroA100.tsp,greedy-ls,random-walk,N1,87,23967,18798,42765,269
kroA100.tsp,steepest-ls,random-walk,N2,70,14216,10294,24510,343
kroB100.tsp,greedy-ls,random-walk,N1,49,19680,20613,40293,243
kroA100.tsp,greedy-ls,greedy-cycle,N2,14,12386,15198,27584,31
kroB100.tsp,greedy-ls,greedy-cycle,N1,30,11027,15421,26448,1082
kroA100.tsp,greedy-ls,random-walk,N2,78,14721,13768,28489,222
kroA100.tsp,greedy-ls,random-walk,N2,97,14906,11527,26433,233
kroA100.tsp,steepest-ls,random-walk,N1,60,24311,17032,41343,475
kroB100.tsp,greedy-ls,greedy-cycle,N2,16,14659,11305,25964,47
kroB100.tsp,greedy-ls,random-walk,N2,59,13490,14160,27650,235
kroB100.tsp,greedy-ls,greedy-cycle,N2,8,11194,14445,25639,33
kroB100.tsp,steepest-ls,greedy-cycle,N1,83,14317,10763,25080,79
kroB100.tsp,steepest-ls,random-walk,N1,100,21007,22070,43077,759
kroA100.tsp,greedy-ls,greedy-cycle,N1,53,15489,12386,27875,43
kroB100.tsp,greedy-ls,greedy-cycle,N1,51,14295,10577,24872,37
kroA100.tsp,steepest-ls,random-walk,N2,27,16890,11859,28749,394
kroA100.tsp,steepest-ls,greedy-cycle,N1,8,14813,12784,27597,61
kroB100.tsp,greedy-ls,greedy-cycle,N1,67,10288,16742,27030,226
kroB100.tsp,steepest-ls,greedy-cycle,N2,93,11108,13814,24922,94
kroA100.tsp,greedy-ls,greedy-cycle,N2,43,12386,15198,27584,28
kroB100.tsp,greedy-ls,greedy-cycle,N2,41,14887,10859,25746,44
kroA100.tsp,steepest-ls,random-walk,N1,37,19412,19645,39057,459
kroB100.tsp,greedy-ls,greedy-cycle,N1,88,15484,11907,27391,325
kroA100.tsp,greedy-ls,greedy-cycle,N1,45,14770,11657,26427,22
kroB100.tsp,steepest-ls,greedy-cycle,N1,95,12212,15896,28108,95
kroA100.tsp,greedy-ls,random-walk,N1,29,18279,17413,35692,270
kroA100.tsp,steepest-ls,random-walk,N2,31,16449,11092,27541,337
kroB100.tsp,greedy-ls,greedy-cycle,N1,47,11140,16283,27423,45
kroA100.tsp,greedy-ls,greedy-cycle,N2,55,11615,13537,25152,35
kroB100.tsp,steepest-ls,greedy-cycle,N2,85,11108,13814,24922,188
kroB100.tsp,greedy-ls,greedy-cycle,N1,71,11220,15678,26898,341
kroA100.tsp,greedy-ls,random-walk,N2,39,14971,10182,25153,455
kroA100.tsp,steepest-ls,random-walk,N1,21,23665,21779,45444,665
kroB100.tsp,greedy-ls,greedy-cycle,N2,57,10827,15612,26439,64
kroB100.tsp,greedy-ls,random-walk,N2,18,17026,12132,29158,201
kroA100.tsp,steepest-ls,random-walk,N2,89,14642,13012,27654,289
kroA100.tsp,steepest-ls,random-walk,N1,6,24201,15309,39510,742
kroA100.tsp,greedy-ls,greedy-cycle,N1,12,11669,16068,27737,51
kroB100.tsp,steepest-ls,greedy-cycle,N1,100,10730,14227,24957,84
kroB100.tsp,steepest-ls,random-walk,N1,4,21934,19213,41147,819
kroB100.tsp,greedy-ls,greedy-cycle,N1,10,11862,16444,28306,33
kroA100.tsp,steepest-ls,random-walk,N2,66,14775,12687,27462,318
kroA100.tsp,greedy-ls,random-walk,N1,91,21605,16703,38308,648
kroB100.tsp,greedy-ls,greedy-cycle,N1,26,10554,14912,25466,247
kroA100.tsp,steepest-ls,random-walk,N1,99,23423,20625,44048,381
kroA100.tsp,steepest-ls,random-walk,N1,76,21223,15070,36293,506
kroA100.tsp,greedy-ls,random-walk,N2,81,14670,9854,24524,877
kroA100.tsp,greedy-ls,greedy-cycle,N1,86,12300,14035,26335,49
kroB100.tsp,steepest-ls,random-walk,N2,66,14007,13772,27779,318
kroB100.tsp,greedy-ls,random-walk,N1,24,22765,19067,41832,222
kroB100.tsp,steepest-ls,greedy-cycle,N1,56,10730,14227,24957,74
kroB100.tsp,greedy-ls,greedy-cycle,N1,84,10826,16765,27591,12
kroB100.tsp,steepest-ls,random-walk,N2,89,15557,12466,28023,319
kroA100.tsp,greedy-ls,greedy-cycle,N1,69,11600,14330,25930,24
kroA100.tsp,steepest-ls,greedy-cycle,N2,70,15486,12386,27872,101
kroA100.tsp,greedy-ls,greedy-cycle,N2,96,11914,14776,26690,37
kroB100.tsp,greedy-ls,random-walk,N2,34,16263,10905,27168,208
kroB100.tsp,steepest-ls,random-walk,N1,76,21870,18330,40200,510
kroB100.tsp,steepest-ls,greedy-cycle,N2,46,10827,15415,26242,64
kroA100.tsp,greedy-ls,random-walk,N2,15,16535,11996,28531,205
kroB100.tsp,steepest-ls,random-walk,N1,99,20170,19915,40085,653
kroB100.tsp,greedy-ls,greedy-cycle,N2,94,10827,15415,26242,36
kroA100.tsp,steepest-ls,greedy-cycle,N1,60,11915,15550,27465,38
kroA100.tsp,greedy-ls,greedy-cycle,N2,79,15489,12386,27875,35
kroB100.tsp,steepest-ls,random-walk,N2,31,16512,13124,29636,449
kroB100.tsp,greedy-ls,random-walk,N1,73,29511,15347,44858,213
kroA100.tsp,steepest-ls,greedy-cycle,N2,27,11713,14957,26670,137
kroA100.tsp,greedy-ls,random-walk,N1,52,20147,17453,37600,261
kroA100.tsp,steepest-ls,random-walk,N2,3,15589,15187,30776,350
kroB100.tsp,steepest-ls,greedy-cycle,N2,11,11108,13814,24922,94
kroB100.tsp,greedy-ls,random-walk,N2,63,15333,15026,30359,646
kroB100.tsp,steepest-ls,random-walk,N1,21,21148,16658,37806,566
kroA100.tsp,steepest-ls,greedy-cycle,N1,37,11502,15434,26936,59
kroB100.tsp,steepest-ls,random-walk,N2,1,16460,11758,28218,322
kroB100.tsp,greedy-ls,greedy-cycle,N1,2,14941,11392,26333,199
kroA100.tsp,greedy-ls,random-walk,N2,42,15321,11695,27016,1350
kroB100.tsp,steepest-ls,greedy-cycle,N1,8,11205,15678,26883,63
kroB100.tsp,steepest-ls,random-walk,N2,27,14930,12661,27591,537
kroB100.tsp,greedy-ls,random-walk,N1,65,20259,20886,41145,219
kroB100.tsp,steepest-ls,greedy-cycle,N1,17,16692,10859,27551,50
kroA100.tsp,greedy-ls,random-walk,N1,44,20707,17086,37793,292
kroA100.tsp,steepest-ls,greedy-cycle,N2,31,11860,10969,22829,333
kroA100.tsp,greedy-ls,greedy-cycle,N1,28,13148,12731,25879,34
kroB100.tsp,greedy-ls,random-walk,N2,75,16851,12030,28881,303
kroB100.tsp,steepest-ls,random-walk,N1,37,24082,20036,44118,563
kroA100.tsp,greedy-ls,random-walk,N2,54,17501,13521,31022,294
kroA100.tsp,greedy-ls,greedy-cycle,N2,38,14435,11657,26092,22
kroA100.tsp,steepest-ls,greedy-cycle,N1,21,14581,11657,26238,42
kroB100.tsp,steepest-ls,greedy-cycle,N1,40,10342,16742,27084,52
kroA100.tsp,greedy-ls,greedy-cycle,N2,5,11502,14705,26207,25
kroB100.tsp,steepest-ls,random-walk,N2,70,17915,11395,29310,563
kroB100.tsp,greedy-ls,random-walk,N1,32,20285,18658,38943,361
kroA100.tsp,greedy-ls,greedy-cycle,N1,90,15513,12386,27899,17
kroA100.tsp,steepest-ls,greedy-cycle,N2,89,11860,10969,22829,244
kroA100.tsp,steepest-ls,greedy-cycle,N2,66,15198,12386,27584,142
kroB100.tsp,greedy-ls,greedy-cycle,N1,92,15178,11867,27045,34
kroA100.tsp,greedy-ls,random-walk,N1,13,20040,24163,44203,963
kroB100.tsp,steepest-ls,greedy-cycle,N2,50,14988,11807,26795,81
kroB100.tsp,greedy-ls,random-walk,N2,22,14793,11885,26678,176
kroB100.tsp,steepest-ls,random-walk,N1,60,22019,17554,39573,561
kroA100.tsp,steepest-ls,greedy-cycle,N1,99,14581,11657,26238,40
kroA100.tsp,greedy-ls,greedy-cycle,N2,80,13485,12074,25559,36
kroA100.tsp,greedy-ls,random-walk,N1,8,24921,15549,40470,300
kroA100.tsp,steepest-ls,greedy-cycle,N1,76,11657,14581,26238,40
kroB100.tsp,greedy-ls,greedy-cycle,N2,82,14801,10498,25299,43
