instance,solver,init_solver,neighbourhood,start_vertex,cost_first,cost_second,total_cost,duration,max_candidates
kroA200.tsp,candidate-ls,random-walk,N2,17,19084,18982,38066,1525,15.0
kroA200.tsp,greedy-cycle,random-walk,N2,196,20645,17365,38010,2,15.0
kroB200.tsp,qc-ls,random-walk,N2,73,22178,21338,43516,327,15.0
kroA200.tsp,steepest-ls,random-walk,N2,27,19329,19332,38661,4629,15.0
kroB200.tsp,candidate-ls,random-walk,N2,150,19241,20756,39997,1541,15.0
kroA200.tsp,steepest-ls,random-walk,N2,166,19264,19008,38272,4811,15.0
kroB200.tsp,greedy-cycle,random-walk,N2,78,18048,20656,38704,3,15.0
kroB200.tsp,candidate-ls,random-walk,N2,30,18639,19347,37986,1490,15.0
kroB200.tsp,greedy-cycle,random-walk,N2,97,20257,18102,38359,2,15.0
kroA200.tsp,qc-ls,random-walk,N2,51,20318,19558,39876,429,15.0
kroB200.tsp,qc-ls,random-walk,N2,136,18802,19266,38068,407,15.0
kroA200.tsp,queue-ls,random-walk,N2,86,21579,21788,43367,328,15.0
kroA200.tsp,candidate-ls,random-walk,N2,40,20796,19330,40126,1395,15.0
kroB200.tsp,queue-ls,random-walk,N2,164,18880,21443,40323,419,15.0
kroB200.tsp,queue-ls,random-walk,N2,49,23232,23028,46260,351,15.0
kroB200.tsp,qc-ls,random-walk,N2,24,20215,21717,41932,326,15.0
kroA200.tsp,steepest-ls,random-walk,N2,70,18350,20744,39094,4165,15.0
kroA200.tsp,queue-ls,random-walk,N2,69,23734,19566,43300,354,15.0
kroB200.tsp,steepest-ls,random-walk,N2,116,17289,18989,36278,4733,15.0
kroB200.tsp,candidate-ls,random-walk,N2,88,20045,19190,39235,1379,15.0
kroB200.tsp,greedy-cycle,random-walk,N2,170,17780,20396,38176,2,15.0
kroB200.tsp,candidate-ls,random-walk,N2,67,20355,18972,39327,1493,15.0
kroA200.tsp,candidate-ls,random-walk,N2,56,18035,20357,38392,1380,15.0
kroA200.tsp,steepest-ls,random-walk,N2,89,19589,19397,38986,4673,15.0
kroA200.tsp,queue-ls,random-walk,N2,90,19113,20128,39241,354,15.0
kroA200.tsp,greedy-cycle,random-walk,N2,138,17534,21403,38937,4,15.0
kroB200.tsp,steepest-ls,random-walk,N2,100,19179,19423,38602,4358,15.0
kroA200.tsp,steepest-ls,random-walk,N2,66,20653,17931,38584,4415,15.0
kroB200.tsp,qc-ls,random-walk,N2,32,20715,21223,41938,312,15.0
kroB200.tsp,queue-ls,random-walk,N2,172,18618,20813,39431,598,15.0
kroB200.tsp,qc-ls,random-walk,N2,198,22025,19182,41207,329,15.0
kroB200.tsp,greedy-cycle,random-walk,N2,39,18352,21333,39685,2,15.0
kroB200.tsp,steepest-ls,random-walk,N2,7,18281,18515,36796,4854,15.0
kroB200.tsp,candidate-ls,random-walk,N2,71,18706,21197,39903,1654,15.0
kroA200.tsp,qc-ls,random-walk,N2,10,22932,20870,43802,358,15.0
kroB200.tsp,greedy-cycle,random-walk,N2,166,20210,18102,38312,2,15.0
kroA200.tsp,greedy-cycle,random-walk,N2,49,17636,21615,39251,2,15.0
kroB200.tsp,candidate-ls,random-walk,N2,146,19454,18515,37969,1474,15.0
kroA200.tsp,steepest-ls,random-walk,N2,31,20218,19548,39766,4853,15.0
kroB200.tsp,qc-ls,random-walk,N2,65,20529,19265,39794,372,15.0
kroA200.tsp,greedy-cycle,random-walk,N2,180,18327,19625,37952,3,15.0
kroA200.tsp,queue-ls,random-walk,N2,28,21292,17538,38830,354,15.0
kroA200.tsp,candidate-ls,random-walk,N2,118,20922,18438,39360,1578,15.0
kroA200.tsp,steepest-ls,random-walk,N2,170,19683,20039,39722,4838,15.0
kroB200.tsp,qc-ls,random-walk,N2,120,20876,18667,39543,506,15.0
kroB200.tsp,qc-ls,random-walk,N2,4,18840,22990,41830,342,15.0
kroA200.tsp,qc-ls,random-walk,N2,47,24513,25750,50263,316,15.0
kroB200.tsp,greedy-cycle,random-walk,N2,81,20747,18065,38812,2,15.0
kroB200.tsp,candidate-ls,random-walk,N2,26,19924,19706,39630,1357,15.0
kroA200.tsp,greedy-cycle,random-walk,N2,32,20645,17365,38010,2,15.0
kroA200.tsp,candidate-ls,random-walk,N2,95,21882,17903,39785,1522,15.0
kroB200.tsp,queue-ls,random-walk,N2,73,19973,24334,44307,357,15.0
kroA200.tsp,queue-ls,random-walk,N2,53,20076,20546,40622,437,15.0
kroA200.tsp,greedy-cycle,random-walk,N2,114,17362,18993,36355,3,15.0
kroB200.tsp,steepest-ls,random-walk,N2,26,18574,21817,40391,4527,15.0
kroA200.tsp,queue-ls,random-walk,N2,130,19706,20520,40226,411,15.0
kroA200.tsp,queue-ls,random-walk,N2,2,21592,26103,47695,274,15.0
kroB200.tsp,greedy-cycle,random-walk,N2,15,17785,17483,35268,2,15.0
kroB200.tsp,qc-ls,random-walk,N2,49,24743,25797,50540,271,15.0
kroB200.tsp,queue-ls,random-walk,N2,24,20583,20935,41518,360,15.0
kroA200.tsp,greedy-cycle,random-walk,N2,65,21564,18253,39817,2,15.0
kroA200.tsp,qc-ls,random-walk,N2,1,23500,20906,44406,355,15.0
kroB200.tsp,steepest-ls,random-walk,N2,194,21543,19738,41281,4465,15.0
kroB200.tsp,steepest-ls,random-walk,N2,71,19990,18523,38513,4504,15.0
kroA200.tsp,qc-ls,random-walk,N2,170,21887,21420,43307,560,15.0
kroB200.tsp,greedy-cycle,random-walk,N2,42,17864,20246,38110,3,15.0
kroA200.tsp,qc-ls,random-walk,N2,84,23129,23933,47062,278,15.0
kroA200.tsp,queue-ls,random-walk,N2,188,24395,24659,49054,294,15.0
kroA200.tsp,candidate-ls,random-walk,N2,134,19790,19008,38798,1991,15.0
kroA200.tsp,greedy-cycle,random-walk,N2,73,20906,18253,39159,2,15.0
kroB200.tsp,queue-ls,random-walk,N2,32,20381,20529,40910,316,15.0
kroB200.tsp,queue-ls,random-walk,N2,3,22466,22831,45297,330,15.0
kroA200.tsp,queue-ls,random-walk,N2,12,23734,24052,47786,300,15.0
kroB200.tsp,steepest-ls,random-walk,N2,182,18556,18189,36745,5004,15.0
kroB200.tsp,steepest-ls,random-walk,N2,67,18171,18597,36768,5070,15.0
kroA200.tsp,candidate-ls,random-walk,N2,122,19680,19000,38680,1837,15.0
kroA200.tsp,qc-ls,random-walk,N2,92,20864,22604,43468,287,15.0
kroB200.tsp,greedy-cycle,random-walk,N2,54,17786,20396,38182,4,15.0
kroB200.tsp,steepest-ls,random-walk,N2,88,19092,20295,39387,4571,15.0
kroA200.tsp,qc-ls,random-walk,N2,166,21452,21469,42921,338,15.0
kroA200.tsp,queue-ls,random-walk,N2,45,26488,27388,53876,260,15.0
kroB200.tsp,queue-ls,random-walk,N2,65,22043,21199,43242,380,15.0
kroA200.tsp,candidate-ls,random-walk,N2,83,18899,19219,38118,1460,15.0
kroA200.tsp,greedy-cycle,random-walk,N2,24,16943,20139,37082,2,15.0
kroB200.tsp,queue-ls,random-walk,N2,148,22132,20782,42914,344,15.0
kroA200.tsp,greedy-cycle,random-walk,N2,102,17061,20167,37228,3,15.0
kroA200.tsp,queue-ls,random-walk,N2,126,21449,22026,43475,326,15.0
kroB200.tsp,steepest-ls,random-walk,N2,30,21224,19119,40343,4718,15.0
kroA200.tsp,candidate-ls,random-walk,N2,1,19618,20634,40252,1627,15.0
kroA200.tsp,candidate-ls,random-walk,N2,102,20661,19106,39767,1444,15.0
kroB200.tsp,greedy-cycle,random-walk,N2,74,17206,20759,37965,3,15.0
kroA200.tsp,qc-ls,random-walk,N2,146,18993,20074,39067,416,15.0
kroB200.tsp,steepest-ls,random-walk,N2,47,20558,17032,37590,4720,15.0
kroB200.tsp,greedy-cycle,random-walk,N2,3,21149,18773,39922,2,15.0
kroB200.tsp,qc-ls,random-walk,N2,90,20886,19925,40811,340,15.0
kroA200.tsp,greedy-cycle,random-walk,N2,53,17458,22307,39765,2,15.0
kroB200.tsp,queue-ls,random-walk,N2,12,23034,24044,47078,345,15.0
kroA200.tsp,queue-ls,random-walk,N2,32,23145,24265,47410,275,15.0
kroB200.tsp,qc-ls,random-walk,N2,182,20704,21049,41753,358,15.0
kroB200.tsp,greedy-cycle,random-walk,N2,23,17910,20396,38306,6,15.0
kroB200.tsp,candidate-ls,random-walk,N2,84,19044,19363,38407,1479,15.0
kroA200.tsp,queue-ls,random-walk,N2,106,20411,20693,41104,369,15.0
kroB200.tsp,steepest-ls,random-walk,N2,10,19173,18636,37809,4841,15.0
kroA200.tsp,steepest-ls,random-walk,N2,93,19135,19576,38711,5221,15.0
kroA200.tsp,greedy-cycle,random-walk,N2,122,18444,18709,37153,2,15.0
kroA200.tsp,queue-ls,random-walk,N2,65,20681,20881,41562,400,15.0
kroB200.tsp,qc-ls,random-walk,N2,28,21947,18970,40917,318,15.0
kroB200.tsp,queue-ls,random-walk,N2,45,23521,21593,45114,369,15.0
kroB200.tsp,queue-ls,random-walk,N2,168,21435,21958,43393,338,15.0
kroB200.tsp,candidate-ls,random-walk,N2,92,18406,20368,38774,1363,15.0
kroB200.tsp,greedy-cycle,random-walk,N2,35,18884,16849,35733,2,15.0
kroB200.tsp,qc-ls,random-walk,N2,194,20218,22855,43073,329,15.0
kroA200.tsp,queue-ls,random-walk,N2,110,22477,20573,43050,423,15.0
kroA200.tsp,greedy-cycle,random-walk,N2,134,16614,21633,38247,4,15.0
kroA200.tsp,steepest-ls,random-walk,N2,85,18302,18477,36779,4987,15.0
kroA200.tsp,greedy-cycle,random-walk,N2,12,16626,21633,38259,2,15.0
kroB200.tsp,queue-ls,random-walk,N2,53,22160,21005,43165,442,15.0
kroA200.tsp,queue-ls,random-walk,N2,73,20175,18861,39036,531,15.0
kroA200.tsp,qc-ls,random-walk,N2,150,20471,18452,38923,409,15.0
kroB200.tsp,greedy-cycle,random-walk,N2,62,21486,18065,39551,5,15.0
kroB200.tsp,queue-ls,random-walk,N2,200,22271,23639,45910,382,15.0
kroA200.tsp,candidate-ls,random-walk,N2,114,21418,18989,40407,1462,15.0
kroB200.tsp,qc-ls,random-walk,N2,8,20467,20244,40711,306,15.0
kroB200.tsp,steepest-ls,random-walk,N2,51,18344,21004,39348,4603,15.0
kroB200.tsp,qc-ls,random-walk,N2,86,18477,19786,38263,345,15.0
kroA200.tsp,queue-ls,random-walk,N2,24,21075,22162,43237,306,15.0
kroB200.tsp,qc-ls,random-walk,N2,69,20854,19866,40720,369,15.0
kroA200.tsp,greedy-cycle,random-walk,N2,45,17924,17472,35396,2,15.0
kroA200.tsp,candidate-ls,random-walk,N2,180,18688,20228,38916,1649,15.0
kroB200.tsp,candidate-ls,random-walk,N2,51,20306,18173,38479,1754,15.0
kroA200.tsp,qc-ls,random-walk,N2,30,22441,24163,46604,319,15.0
kroB200.tsp,greedy-cycle,random-walk,N2,146,21600,18649,40249,2,15.0
kroA200.tsp,steepest-ls,random-walk,N2,2,19869,19082,38951,4889,15.0
kroA200.tsp,greedy-cycle,random-walk,N2,2,18893,20745,39638,2,15.0
kroB200.tsp,greedy-cycle,random-walk,N2,19,17024,19852,36876,2,15.0
kroB200.tsp,steepest-ls,random-walk,N2,120,19473,19647,39120,4866,15.0
kroA200.tsp,steepest-ls,random-walk,N2,46,18989,19881,38870,4727,15.0
kroB200.tsp,qc-ls,random-walk,N2,12,21492,19336,40828,354,15.0
kroA200.tsp,candidate-ls,random-walk,N2,99,20143,19741,39884,1428,15.0
kroB200.tsp,queue-ls,random-walk,N2,152,19188,22201,41389,362,15.0
kroA200.tsp,candidate-ls,random-walk,N2,76,19207,17411,36618,1433,15.0
kroB200.tsp,queue-ls,random-walk,N2,90,21703,19717,41420,343,15.0
kroA200.tsp,greedy-cycle,random-walk,N2,118,21703,18093,39796,3,15.0
kroB200.tsp,qc-ls,random-walk,N2,100,22322,19004,41326,295,15.0
kroA200.tsp,qc-ls,random-walk,N2,67,20516,22183,42699,336,15.0
kroA200.tsp,candidate-ls,random-walk,N2,138,19388,19714,39102,1569,15.0
kroA200.tsp,queue-ls,random-walk,N2,184,22871,19415,42286,355,15.0
kroA200.tsp,qc-ls,random-walk,N2,88,19736,22489,42225,302,15.0
kroB200.tsp,steepest-ls,random-walk,N2,92,19626,19791,39417,4498,15.0
kroA200.tsp,steepest-ls,random-walk,N2,150,18333,20186,38519,4842,15.0
kroA200.tsp,greedy-cycle,random-walk,N2,69,17669,22204,39873,2,15.0
kroB200.tsp,candidate-ls,random-walk,N2,166,19773,19095,38868,1439,15.0
kroB200.tsp,queue-ls,random-walk,N2,28,22115,19911,42026,320,15.0
kroA200.tsp,steepest-ls,random-walk,N2,11,18997,19124,38121,4887,15.0
kroB200.tsp,qc-ls,random-walk,N2,45,24464,25349,49813,323,15.0
kroB200.tsp,steepest-ls,random-walk,N2,198,18073,20950,39023,4871,15.0
kroA200.tsp,candidate-ls,random-walk,N2,21,20213,19704,39917,1732,15.0
kroA200.tsp,greedy-cycle,random-walk,N2,86,21218,17365,38583,3,15.0
kroB200.tsp,candidate-ls,random-walk,N2,10,17837,18602,36439,1584,15.0
kroA200.tsp,qc-ls,random-walk,N2,71,21315,21502,42817,369,15.0
kroB200.tsp,qc-ls,random-walk,N2,116,19902,19771,39673,662,15.0
kroA200.tsp,steepest-ls,random-walk,N2,146,19129,19299,38428,4516,15.0
kroB200.tsp,steepest-ls,random-walk,N2,84,18273,19428,37701,4670,15.0
kroB200.tsp,greedy-cycle,random-walk,N2,58,20210,18102,38312,4,15.0
kroA200.tsp,queue-ls,random-walk,N2,192,21213,18722,39935,607,15.0
kroB200.tsp,qc-ls,random-walk,N2,53,20648,18511,39159,371,15.0
kroB200.tsp,candidate-ls,random-walk,N2,170,19526,18943,38469,1592,15.0
kroA200.tsp,greedy-cycle,random-walk,N2,90,17669,22204,39873,3,15.0
kroA200.tsp,candidate-ls,random-walk,N2,37,19873,21514,41387,1488,15.0
kroB200.tsp,greedy-cycle,random-walk,N2,150,17606,20396,38002,2,15.0
kroA200.tsp,qc-ls,random-walk,N2,26,19775,20007,39782,333,15.0
kroB200.tsp,candidate-ls,random-walk,N2,47,19643,19993,39636,1642,15.0
kroA200.tsp,candidate-ls,random-walk,N2,196,18810,19670,38480,1482,15.0
kroB200.tsp,queue-ls,random-walk,N2,144,18273,21627,39900,435,15.0
kroA200.tsp,greedy-cycle,random-walk,N2,28,18068,17472,35540,2,15.0
kroB200.tsp,queue-ls,random-walk,N2,69,24926,24805,49731,377,15.0
kroA200.tsp,steepest-ls,random-walk,N2,50,19757,19810,39567,4814,15.0
kroA200.tsp,queue-ls,random-walk,N2,49,19726,23051,42777,371,15.0
kroB200.tsp,steepest-ls,random-walk,N2,136,20514,18550,39064,4717,15.0
kroB200.tsp,queue-ls,random-walk,N2,86,23881,22304,46185,312,15.0
kroA200.tsp,candidate-ls,random-walk,N2,60,16924,19894,36818,1355,15.0
kroB200.tsp,candidate-ls,random-walk,N2,126,21419,20187,41606,1412,15.0
kroA200.tsp,greedy-cycle,random-walk,N2,29,17298,22606,39904,2,15.0
kroB200.tsp,queue-ls,random-walk,N2,68,21072,22682,43754,315,15.0
kroA200.tsp,steepest-ls,random-walk,N2,51,20341,19432,39773,4893,15.0
kroA200.tsp,queue-ls,random-walk,N2,48,22277,21166,43443,314,15.0
kroB200.tsp,queue-ls,random-walk,N2,87,19480,20276,39756,416,15.0
kroA200.tsp,candidate-ls,random-walk,N2,61,20177,19275,39452,1573,15.0
kroB200.tsp,qc-ls,random-walk,N2,140,20275,20605,40880,416,15.0
kroA200.tsp,qc-ls,random-walk,N2,27,22208,19548,41756,336,15.0
kroB200.tsp,candidate-ls,random-walk,N2,46,18973,19790,38763,1370,15.0
kroA200.tsp,candidate-ls,random-walk,N2,178,19169,19762,38931,1479,15.0
kroA200.tsp,steepest-ls,random-walk,N2,110,20319,18697,39016,4588,15.0
kroB200.tsp,steepest-ls,random-walk,N2,160,18018,19204,37222,4733,15.0
kroB200.tsp,qc-ls,random-walk,N2,52,20540,21348,41888,312,15.0
kroB200.tsp,queue-ls,random-walk,N2,112,19825,22144,41969,356,15.0
kroA200.tsp,greedy-cycle,random-walk,N2,91,21703,18093,39796,2,15.0
kroA200.tsp,candidate-ls,random-walk,N2,36,21367,20077,41444,1334,15.0
kroA200.tsp,greedy-cycle,random-walk,N2,158,17924,17472,35396,2,15.0
kroB200.tsp,candidate-ls,random-walk,N2,11,21367,18633,40000,1508,15.0
kroA200.tsp,qc-ls,random-walk,N2,70,23553,23604,47157,291,15.0
kroB200.tsp,greedy-cycle,random-walk,N2,106,20263,18102,38365,3,15.0
kroA200.tsp,qc-ls,random-walk,N2,184,23633,22453,46086,383,15.0
kroB200.tsp,steepest-ls,random-walk,N2,85,20500,20713,41213,4456,15.0
kroB200.tsp,greedy-cycle,random-walk,N2,59,17789,20510,38299,3,15.0
kroB200.tsp,queue-ls,random-walk,N2,104,22154,21663,43817,302,15.0
kroA200.tsp,greedy-cycle,random-walk,N2,68,21416,18093,39509,3,15.0
kroB200.tsp,queue-ls,random-walk,N2,29,21788,18979,40767,456,15.0
kroB200.tsp,qc-ls,random-walk,N2,44,22942,20823,43765,293,15.0
kroA200.tsp,steepest-ls,random-walk,N2,10,20248,18585,38833,4721,15.0
kroB200.tsp,steepest-ls,random-walk,N2,176,17419,20530,37949,4491,15.0
kroA200.tsp,candidate-ls,random-walk,N2,20,19909,20122,40031,1320,15.0
kroA200.tsp,greedy-cycle,random-walk,N2,87,16872,20167,37039,2,15.0
kroB200.tsp,candidate-ls,random-walk,N2,188,18976,20133,39109,1479,15.0
kroA200.tsp,qc-ls,random-walk,N2,192,19475,22221,41696,387,15.0
kroB200.tsp,greedy-cycle,random-walk,N2,110,18658,21333,39991,3,15.0
kroA200.tsp,qc-ls,random-walk,N2,66,20041,18388,38429,323,15.0
kroA200.tsp,qc-ls,random-walk,N2,89,21263,19768,41031,588,15.0
kroB200.tsp,steepest-ls,random-walk,N2,93,19851,18524,38375,4713,15.0
kroB200.tsp,qc-ls,random-walk,N2,13,20975,21076,42051,375,15.0
kroA200.tsp,steepest-ls,random-walk,N2,47,20227,17949,38176,4839,15.0
kroA200.tsp,candidate-ls,random-walk,N2,98,19644,18916,38560,1319,15.0
kroB200.tsp,candidate-ls,random-walk,N2,130,20741,18900,39641,1456,15.0
kroA200.tsp,candidate-ls,random-walk,N2,77,19577,20481,40058,1521,15.0
kroB200.tsp,queue-ls,random-walk,N2,91,18903,22710,41613,388,15.0
kroB200.tsp,candidate-ls,random-walk,N2,50,19820,19961,39781,1394,15.0
kroA200.tsp,qc-ls,random-walk,N2,31,22268,21466,43734,319,15.0
kroB200.tsp,qc-ls,random-walk,N2,156,18765,21816,40581,483,15.0
kroA200.tsp,steepest-ls,random-walk,N2,3,20777,18862,39639,5392,15.0
kroA200.tsp,greedy-cycle,random-walk,N2,3,20757,17365,38122,2,15.0
kroA200.tsp,steepest-ls,random-walk,N2,106,21085,19444,40529,4699,15.0
kroB200.tsp,greedy-cycle,random-walk,N2,18,17685,20396,38081,2,15.0
kroB200.tsp,qc-ls,random-walk,N2,87,23042,19988,43030,343,15.0
kroA200.tsp,greedy-cycle,random-walk,N2,162,18206,17472,35678,3,15.0
kroA200.tsp,queue-ls,random-walk,N2,25,21578,18740,40318,390,15.0
kroB200.tsp,qc-ls,random-walk,N2,68,20870,21823,42693,306,15.0
kroA200.tsp,greedy-cycle,random-walk,N2,44,20726,17365,38091,2,15.0
kroB200.tsp,queue-ls,random-walk,N2,128,19655,20627,40282,412,15.0
kroB200.tsp,greedy-cycle,random-walk,N2,63,20857,18065,38922,2,15.0
kroA200.tsp,queue-ls,random-walk,N2,146,20055,18645,38700,340,15.0
kroB200.tsp,qc-ls,random-walk,N2,9,20222,18437,38659,382,15.0
kroB200.tsp,steepest-ls,random-walk,N2,50,17814,19653,37467,4587,15.0
kroA200.tsp,steepest-ls,random-walk,N2,192,19056,20099,39155,4557,15.0
kroA200.tsp,steepest-ls,random-walk,N2,84,20400,18575,38975,4823,15.0
kroB200.tsp,queue-ls,random-walk,N2,190,20112,19322,39434,375,15.0
kroA200.tsp,greedy-cycle,random-walk,N2,13,20543,18253,38796,2,15.0
kroB200.tsp,queue-ls,random-walk,N2,52,17797,19558,37355,344,15.0
kroA200.tsp,queue-ls,random-walk,N2,72,21068,22110,43178,326,15.0
kroB200.tsp,candidate-ls,random-walk,N2,93,19567,19332,38899,1541,15.0
kroA200.tsp,candidate-ls,random-walk,N2,142,17550,18918,36468,1612,15.0
kroB200.tsp,greedy-cycle,random-walk,N2,34,18713,20519,39232,2,15.0
kroA200.tsp,qc-ls,random-walk,N2,106,19579,19306,38885,400,15.0
kroB200.tsp,greedy-cycle,random-walk,N2,184,17825,20246,38071,2,15.0
kroB200.tsp,queue-ls,random-walk,N2,186,19573,20047,39620,376,15.0
kroA200.tsp,steepest-ls,random-walk,N2,92,20109,18814,38923,4858,15.0
kroA200.tsp,queue-ls,random-walk,N2,64,22455,20003,42458,351,15.0
kroB200.tsp,qc-ls,random-walk,N2,29,20052,19158,39210,405,15.0
kroB200.tsp,queue-ls,random-walk,N2,44,20465,20312,40777,354,15.0
kroB200.tsp,greedy-cycle,random-walk,N2,192,17786,20396,38182,2,15.0
kroA200.tsp,qc-ls,random-walk,N2,110,20268,19195,39463,355,15.0
kroB200.tsp,greedy-cycle,random-walk,N2,22,17780,20396,38176,2,15.0
kroA200.tsp,candidate-ls,random-walk,N2,154,18541,21701,40242,1598,15.0
kroB200.tsp,candidate-ls,random-walk,N2,85,19977,19853,39830,1503,15.0
kroB200.tsp,steepest-ls,random-walk,N2,11,21033,18594,39627,4425,15.0
kroB200.tsp,greedy-cycle,random-walk,N2,2,20595,18141,38736,2,15.0
kroA200.tsp,greedy-cycle,random-walk,N2,174,21703,18093,39796,2,15.0
kroB200.tsp,qc-ls,random-walk,N2,91,18999,20875,39874,334,15.0
kroA200.tsp,greedy-cycle,random-walk,N2,52,17362,18993,36355,2,15.0
kroB200.tsp,queue-ls,random-walk,N2,13,25067,21894,46961,350,15.0
kroA200.tsp,queue-ls,random-walk,N2,33,19650,21294,40944,359,15.0
kroB200.tsp,greedy-cycle,random-walk,N2,75,20595,18141,38736,5,15.0
kroA200.tsp,steepest-ls,random-walk,N2,184,18473,18618,37091,4777,15.0
kroB200.tsp,steepest-ls,random-walk,N2,46,18674,19431,38105,4704,15.0
kroA200.tsp,queue-ls,random-walk,N2,150,22343,20093,42436,406,15.0
kroB200.tsp,steepest-ls,random-walk,N2,31,19978,19028,39006,4518,15.0
kroA200.tsp,qc-ls,random-walk,N2,130,26249,30788,57037,232,15.0
kroA200.tsp,candidate-ls,random-walk,N2,174,19521,18043,37564,1469,15.0
kroA200.tsp,queue-ls,random-walk,N2,44,22629,25718,48347,288,15.0
kroB200.tsp,queue-ls,random-walk,N2,64,23725,22858,46583,256,15.0
kroA200.tsp,candidate-ls,random-walk,N2,82,20126,17988,38114,1455,15.0
kroA200.tsp,greedy-cycle,random-walk,N2,25,18273,17472,35745,2,15.0
kroA200.tsp,qc-ls,random-walk,N2,188,23772,22428,46200,376,15.0
kroB200.tsp,steepest-ls,random-walk,N2,66,20169,18707,38876,4736,15.0
kroA200.tsp,queue-ls,random-walk,N2,170,23706,21189,44895,310,15.0
kroA200.tsp,qc-ls,random-walk,N2,93,19715,22140,41855,316,15.0
kroB200.tsp,greedy-cycle,random-walk,N2,55,18449,21333,39782,2,15.0
kroB200.tsp,steepest-ls,random-walk,N2,89,18644,20003,38647,4437,15.0
kroA200.tsp,greedy-cycle,random-walk,N2,72,18893,20745,39638,2,15.0
kroB200.tsp,queue-ls,random-walk,N2,2,24235,25675,49910,271,15.0
kroB200.tsp,queue-ls,random-walk,N2,33,20849,21496,42345,376,15.0
kroA200.tsp,queue-ls,random-walk,N2,13,22981,19620,42601,414,15.0
kroA200.tsp,greedy-cycle,random-walk,N2,154,16595,22671,39266,2,15.0
kroB200.tsp,candidate-ls,random-walk,N2,192,18696,19380,38076,1700,15.0
kroA200.tsp,queue-ls,random-walk,N2,166,19923,20997,40920,414,15.0
kroB200.tsp,steepest-ls,random-walk,N2,70,20247,19519,39766,5275,15.0
kroB200.tsp,greedy-cycle,random-walk,N2,43,17675,20396,38071,2,15.0
kroA200.tsp,qc-ls,random-walk,N2,85,18773,20036,38809,343,15.0
kroB200.tsp,qc-ls,random-walk,N2,48,21652,18882,40534,333,15.0
kroB200.tsp,queue-ls,random-walk,N2,25,21718,17701,39419,426,15.0
kroA200.tsp,greedy-cycle,random-walk,N2,64,16819,21633,38452,2,15.0
kroB200.tsp,queue-ls,random-walk,N2,108,21217,18015,39232,408,15.0
kroB200.tsp,candidate-ls,random-walk,N2,184,18929,21909,40838,1348,15.0
kroA200.tsp,greedy-cycle,random-walk,N2,142,16943,20139,37082,3,15.0
kroB200.tsp,steepest-ls,random-walk,N2,27,19667,19379,39046,4772,15.0
kroA200.tsp,queue-ls,random-walk,N2,3,23027,19343,42370,390,15.0
kroA200.tsp,candidate-ls,random-walk,N2,162,19036,19416,38452,1541,15.0
kroB200.tsp,greedy-cycle,random-walk,N2,14,21600,18649,40249,2,15.0
kroA200.tsp,qc-ls,random-walk,N2,126,24762,21544,46306,344,15.0
kroA200.tsp,greedy-cycle,random-walk,N2,33,16943,20139,37082,2,15.0
kroA200.tsp,candidate-ls,random-walk,N2,94,20750,19104,39854,1353,15.0
kroB200.tsp,queue-ls,random-walk,N2,72,22091,19945,42036,327,15.0
kroA200.tsp,queue-ls,random-walk,N2,52,20855,20266,41121,343,15.0
kroB200.tsp,greedy-cycle,random-walk,N2,130,18113,20453,38566,3,15.0
kroB200.tsp,qc-ls,random-walk,N2,5,18177,19655,37832,384,15.0
kroA200.tsp,qc-ls,random-walk,N2,46,22377,27043,49420,295,15.0
kroB200.tsp,greedy-cycle,random-walk,N2,80,18048,20656,38704,3,15.0
kroB200.tsp,candidate-ls,random-walk,N2,27,18830,18727,37557,1552,15.0
kroB200.tsp,queue-ls,random-walk,N2,124,25299,23895,49194,412,15.0
kroA200.tsp,greedy-cycle,random-walk,N2,48,18068,17472,35540,2,15.0
kroB200.tsp,candidate-ls,random-walk,N2,1,19275,19842,39117,1617,15.0
kroB200.tsp,qc-ls,random-walk,N2,64,18855,21986,40841,315,15.0
kroA200.tsp,steepest-ls,random-walk,N2,30,20181,19148,39329,4853,15.0
kroA200.tsp,queue-ls,random-walk,N2,29,21457,19958,41415,544,15.0
kroB200.tsp,steepest-ls,random-walk,N2,156,18350,18813,37163,4640,15.0
kroB200.tsp,greedy-cycle,random-walk,N2,188,18253,21333,39586,6,15.0
kroA200.tsp,steepest-ls,random-walk,N2,126,19267,19040,38307,4628,15.0
kroB200.tsp,greedy-cycle,random-walk,N2,38,18256,21333,39589,3,15.0
kroB200.tsp,steepest-ls,random-walk,N2,6,20417,18545,38962,4784,15.0
kroB200.tsp,candidate-ls,random-walk,N2,70,19373,19388,38761,1487,15.0
kroA200.tsp,qc-ls,random-walk,N2,11,18648,19742,38390,383,15.0
kroB200.tsp,qc-ls,random-walk,N2,176,23698,23375,47073,428,15.0
kroA200.tsp,candidate-ls,random-walk,N2,57,20002,19377,39379,1447,15.0
kroA200.tsp,steepest-ls,random-walk,N2,88,18310,20567,38877,4774,15.0
kroA200.tsp,queue-ls,random-walk,N2,91,20682,18892,39574,420,15.0
kroB200.tsp,qc-ls,random-walk,N2,33,20636,19353,39989,370,15.0
kroA200.tsp,steepest-ls,random-walk,N2,67,17218,20619,37837,4853,15.0
kroB200.tsp,candidate-ls,random-walk,N2,110,18279,19989,38268,1553,15.0
kroB200.tsp,candidate-ls,random-walk,N2,89,19134,21127,40261,1532,15.0
kroA200.tsp,candidate-ls,random-walk,N2,158,19241,18522,37763,1591,15.0
kroA200.tsp,steepest-ls,random-walk,N2,130,19232,17367,36599,4695,15.0
kroB200.tsp,qc-ls,random-walk,N2,160,20628,21322,41950,411,15.0
kroB200.tsp,candidate-ls,random-walk,N2,66,19338,19008,38346,1413,15.0
kroA200.tsp,queue-ls,random-walk,N2,87,30874,28080,58954,251,15.0
kroA200.tsp,candidate-ls,random-walk,N2,41,20770,19122,39892,1453,15.0
kroB200.tsp,candidate-ls,random-walk,N2,106,18334,20317,38651,1548,15.0
kroB200.tsp,queue-ls,random-walk,N2,48,28558,23797,52355,266,15.0
kroA200.tsp,steepest-ls,random-walk,N2,71,19284,18940,38224,4840,15.0
kroB200.tsp,qc-ls,random-walk,N2,25,22347,21229,43576,337,15.0
kroA200.tsp,queue-ls,random-walk,N2,68,25084,22987,48071,275,15.0
kroB200.tsp,greedy-cycle,random-walk,N2,79,17024,19852,36876,3,15.0
kroB200.tsp,candidate-ls,random-walk,N2,31,19421,20137,39558,1992,15.0
kroB200.tsp,greedy-cycle,random-walk,N2,96,20595,18141,38736,3,15.0
kroA200.tsp,qc-ls,random-walk,N2,50,20169,22037,42206,333,15.0
kroA200.tsp,steepest-ls,random-walk,N2,188,18409,20180,38589,4914,15.0
kroB200.tsp,greedy-cycle,random-walk,N2,126,18041,20656,38697,3,15.0
kroA200.tsp,candidate-ls,random-walk,N2,16,20520,18456,38976,1350,15.0
kroA200.tsp,greedy-cycle,random-walk,N2,178,21586,18253,39839,2,15.0
kroB200.tsp,steepest-ls,random-walk,N2,140,19612,19624,39236,4703,15.0
kroA200.tsp,steepest-ls,random-walk,N2,26,19551,17812,37363,4756,15.0
kroB200.tsp,qc-ls,random-walk,N2,72,19696,20997,40693,340,15.0
kroB200.tsp,queue-ls,random-walk,N2,132,24475,21228,45703,359,15.0
kroA200.tsp,qc-ls,random-walk,N2,140,21693,20779,42472,360,15.0
kroA200.tsp,candidate-ls,random-walk,N2,104,19806,20327,40133,1477,15.0
kroB200.tsp,greedy-cycle,random-walk,N2,72,19306,17792,37098,4,15.0
kroB200.tsp,steepest-ls,random-walk,N2,41,18702,20724,39426,4678,15.0
kroB200.tsp,greedy-cycle,random-walk,N2,5,21149,18773,39922,2,15.0
kroB200.tsp,qc-ls,random-walk,N2,96,23517,21287,44804,317,15.0
kroB200.tsp,qc-ls,random-walk,N2,79,21651,24972,46623,346,15.0
kroB200.tsp,queue-ls,random-walk,N2,14,19188,22019,41207,336,15.0
kroA200.tsp,queue-ls,random-walk,N2,34,29496,27376,56872,281,15.0
kroA200.tsp,greedy-cycle,random-walk,N2,55,17553,20167,37720,2,15.0
kroB200.tsp,greedy-cycle,random-walk,N2,25,18449,21333,39782,3,15.0
kroB200.tsp,candidate-ls,random-walk,N2,82,19468,19487,38955,1331,15.0
kroB200.tsp,qc-ls,random-walk,N2,184,19677,19564,39241,588,15.0
kroB200.tsp,steepest-ls,random-walk,N2,16,19617,19415,39032,4423,15.0
kroA200.tsp,queue-ls,random-walk,N2,100,20167,17701,37868,374,15.0
kroA200.tsp,steepest-ls,random-walk,N2,95,18559,19250,37809,6359,15.0
kroA200.tsp,greedy-cycle,random-walk,N2,124,18327,19625,37952,5,15.0
kroA200.tsp,queue-ls,random-walk,N2,63,26850,23561,50411,306,15.0
kroB200.tsp,queue-ls,random-walk,N2,43,21811,22239,44050,394,15.0
kroB200.tsp,qc-ls,random-walk,N2,192,20294,21158,41452,357,15.0
kroB200.tsp,candidate-ls,random-walk,N2,94,17826,20191,38017,1488,15.0
kroB200.tsp,greedy-cycle,random-walk,N2,33,17191,21859,39050,5,15.0
kroA200.tsp,queue-ls,random-walk,N2,116,20637,20482,41119,381,15.0
kroA200.tsp,greedy-cycle,random-walk,N2,132,17402,18062,35464,6,15.0
kroA200.tsp,steepest-ls,random-walk,N2,83,19042,19500,38542,4900,15.0
kroB200.tsp,qc-ls,random-walk,N2,38,21134,18455,39589,334,15.0
kroB200.tsp,queue-ls,random-walk,N2,55,21516,21174,42690,382,15.0
kroA200.tsp,queue-ls,random-walk,N2,75,20032,21292,41324,376,15.0
kroA200.tsp,greedy-cycle,random-walk,N2,14,18444,18709,37153,3,15.0
kroB200.tsp,queue-ls,random-walk,N2,178,20504,19954,40458,347,15.0
kroB200.tsp,greedy-cycle,random-walk,N2,64,18157,20656,38813,5,15.0
kroA200.tsp,candidate-ls,random-walk,N2,112,20017,20775,40792,1544,15.0
kroA200.tsp,qc-ls,random-walk,N2,156,22329,21587,43916,361,15.0
kroB200.tsp,steepest-ls,random-walk,N2,57,20224,18473,38697,5003,15.0
kroB200.tsp,qc-ls,random-walk,N2,80,21455,21251,42706,303,15.0
kroA200.tsp,greedy-cycle,random-walk,N2,43,21596,18253,39849,2,15.0
kroA200.tsp,queue-ls,random-walk,N2,22,19906,19411,39317,347,15.0
kroB200.tsp,greedy-cycle,random-walk,N2,140,16949,21551,38500,2,15.0
kroB200.tsp,candidate-ls,random-walk,N2,57,20537,18958,39495,1610,15.0
kroA200.tsp,candidate-ls,random-walk,N2,186,20102,20083,40185,1540,15.0
kroA200.tsp,qc-ls,random-walk,N2,36,20994,19650,40644,360,15.0
kroA200.tsp,queue-ls,random-walk,N2,8,19890,20326,40216,388,15.0
kroA200.tsp,greedy-cycle,random-walk,N2,4,18193,21615,39808,2,15.0
kroA200.tsp,steepest-ls,random-walk,N2,4,19036,20776,39812,4745,15.0
kroB200.tsp,queue-ls,random-walk,N2,154,19942,21042,40984,405,15.0
kroA200.tsp,greedy-cycle,random-walk,N2,38,16872,20167,37039,2,15.0
kroB200.tsp,steepest-ls,random-walk,N2,126,20102,18247,38349,4698,15.0
kroA200.tsp,queue-ls,random-walk,N2,59,21479,20870,42349,410,15.0
kroB200.tsp,queue-ls,random-walk,N2,79,20921,19935,40856,453,15.0
kroA200.tsp,steepest-ls,random-walk,N2,40,19779,18283,38062,4544,15.0
kroB200.tsp,qc-ls,random-walk,N2,14,21189,21058,42247,324,15.0
kroB200.tsp,queue-ls,random-walk,N2,96,21953,27032,48985,266,15.0
kroA200.tsp,candidate-ls,random-walk,N2,70,19783,20196,39979,1360,15.0
kroA200.tsp,qc-ls,random-walk,N2,61,21241,21053,42294,332,15.0
kroB200.tsp,qc-ls,random-walk,N2,106,19422,20496,39918,932,15.0
kroB200.tsp,steepest-ls,random-walk,N2,94,18725,19198,37923,4959,15.0
kroA200.tsp,steepest-ls,random-walk,N2,156,19641,20547,40188,4710,15.0
kroA200.tsp,queue-ls,random-walk,N2,182,19668,18549,38217,349,15.0
kroB200.tsp,greedy-cycle,random-walk,N2,48,17075,19852,36927,5,15.0
kroA200.tsp,steepest-ls,random-walk,N2,17,19446,18344,37790,4744,15.0
kroB200.tsp,qc-ls,random-walk,N2,43,24331,25141,49472,314,15.0
kroB200.tsp,candidate-ls,random-walk,N2,160,18699,18875,37574,1431,15.0
kroA200.tsp,candidate-ls,random-walk,N2,27,18340,20438,38778,1452,15.0
kroA200.tsp,greedy-cycle,random-walk,N2,80,20726,17365,38091,4,15.0
kroB200.tsp,qc-ls,random-walk,N2,110,18908,21981,40889,779,15.0
kroB200.tsp,candidate-ls,random-walk,N2,16,17876,20873,38749,1501,15.0
kroA200.tsp,qc-ls,random-walk,N2,77,19955,21027,40982,447,15.0
kroA200.tsp,qc-ls,random-walk,N2,98,20604,19440,40044,350,15.0
kroA200.tsp,queue-ls,random-walk,N2,194,20134,21550,41684,407,15.0
kroA200.tsp,candidate-ls,random-walk,N2,128,20892,19196,40088,1869,15.0
kroA200.tsp,steepest-ls,random-walk,N2,140,18027,18887,36914,4887,15.0
kroB200.tsp,steepest-ls,random-walk,N2,82,18232,19236,37468,4588,15.0
kroB200.tsp,candidate-ls,random-walk,N2,176,18717,20609,39326,1522,15.0
kroA200.tsp,greedy-cycle,random-walk,N2,79,17733,22307,40040,2,15.0
kroA200.tsp,queue-ls,random-walk,N2,18,24542,22696,47238,265,15.0
kroB200.tsp,queue-ls,random-walk,N2,9,19215,20555,39770,534,15.0
kroB200.tsp,queue-ls,random-walk,N2,38,20992,20653,41645,365,15.0
kroB200.tsp,qc-ls,random-walk,N2,55,20936,21431,42367,343,15.0
kroB200.tsp,steepest-ls,random-walk,N2,188,20508,18618,39126,4664,15.0
kroA200.tsp,greedy-cycle,random-walk,N2,96,20726,17365,38091,5,15.0
kroA200.tsp,candidate-ls,random-walk,N2,31,19345,19641,38986,1448,15.0
kroA200.tsp,qc-ls,random-walk,N2,20,20757,21413,42170,309,15.0
kroA200.tsp,candidate-ls,random-walk,N2,190,20839,18491,39330,1522,15.0
kroB200.tsp,candidate-ls,random-walk,N2,41,18105,21144,39249,1780,15.0
kroB200.tsp,greedy-cycle,random-walk,N2,156,18713,20519,39232,2,15.0
kroA200.tsp,steepest-ls,random-walk,N2,56,18799,18908,37707,4737,15.0
kroB200.tsp,steepest-ls,random-walk,N2,130,19454,19774,39228,4450,15.0
kroB200.tsp,queue-ls,random-walk,N2,142,20776,19877,40653,341,15.0
kroA200.tsp,candidate-ls,random-walk,N2,89,19796,17821,37617,1592,15.0
kroA200.tsp,candidate-ls,random-walk,N2,66,19924,17534,37458,1422,15.0
kroA200.tsp,greedy-cycle,random-walk,N2,108,17458,22307,39765,2,15.0
kroB200.tsp,queue-ls,random-walk,N2,80,21917,20622,42539,312,15.0
kroB200.tsp,greedy-cycle,random-walk,N2,9,18658,21333,39991,2,15.0
kroA200.tsp,candidate-ls,random-walk,N2,11,19013,19812,38825,1744,15.0
kroB200.tsp,candidate-ls,random-walk,N2,156,17684,19580,37264,1683,15.0
kroA200.tsp,greedy-cycle,random-walk,N2,59,20757,17365,38122,2,15.0
kroA200.tsp,queue-ls,random-walk,N2,38,18009,21054,39063,347,15.0
kroA200.tsp,greedy-cycle,random-walk,N2,190,18444,18709,37153,3,15.0
kroB200.tsp,queue-ls,random-walk,N2,18,19451,19505,38956,359,15.0
kroB200.tsp,qc-ls,random-walk,N2,75,20535,19760,40295,379,15.0
kroA200.tsp,steepest-ls,random-walk,N2,21,20045,18015,38060,4822,15.0
kroA200.tsp,candidate-ls,random-walk,N2,108,19683,19669,39352,1513,15.0
kroA200.tsp,steepest-ls,random-walk,N2,160,20118,19024,39142,4584,15.0
kroB200.tsp,qc-ls,random-walk,N2,130,23233,21487,44720,319,15.0
kroB200.tsp,candidate-ls,random-walk,N2,36,20307,18132,38439,1555,15.0
kroA200.tsp,qc-ls,random-walk,N2,57,22297,24020,46317,408,15.0
kroB200.tsp,greedy-cycle,random-walk,N2,91,17606,20396,38002,2,15.0
kroA200.tsp,candidate-ls,random-walk,N2,46,19454,20780,40234,1519,15.0
kroA200.tsp,greedy-cycle,random-walk,N2,128,17061,20167,37228,4,15.0
kroA200.tsp,queue-ls,random-walk,N2,80,26661,28749,55410,227,15.0
kroA200.tsp,steepest-ls,random-walk,N2,99,19693,18254,37947,5641,15.0
kroB200.tsp,qc-ls,random-walk,N2,22,18971,20770,39741,363,15.0
kroA200.tsp,steepest-ls,random-walk,N2,76,20849,18163,39012,4814,15.0
kroB200.tsp,steepest-ls,random-walk,N2,110,19901,18167,38068,4907,15.0
kroB200.tsp,queue-ls,random-walk,N2,162,18636,20571,39207,380,15.0
kroB200.tsp,qc-ls,random-walk,N2,188,17983,23528,41511,358,15.0
kroB200.tsp,greedy-cycle,random-walk,N2,29,17090,20759,37849,3,15.0
kroB200.tsp,candidate-ls,random-walk,N2,61,19935,19352,39287,1765,15.0
kroB200.tsp,greedy-cycle,random-walk,N2,176,17622,20396,38018,2,15.0
kroA200.tsp,queue-ls,random-walk,N2,96,28025,27881,55906,271,15.0
kroA200.tsp,candidate-ls,random-walk,N2,50,17502,19960,37462,1396,15.0
kroB200.tsp,queue-ls,random-walk,N2,174,21018,20324,41342,394,15.0
kroA200.tsp,greedy-cycle,random-walk,N2,18,21703,18093,39796,2,15.0
kroB200.tsp,steepest-ls,random-walk,N2,106,19217,17907,37124,4839,15.0
kroA200.tsp,queue-ls,random-walk,N2,79,20267,22720,42987,337,15.0
kroB200.tsp,queue-ls,random-walk,N2,59,24656,21680,46336,391,15.0
kroA200.tsp,steepest-ls,random-walk,N2,60,18012,18487,36499,4736,15.0
kroB200.tsp,qc-ls,random-walk,N2,34,20390,21112,41502,329,15.0
kroB200.tsp,candidate-ls,random-walk,N2,98,20320,18673,38993,1375,15.0
kroB200.tsp,steepest-ls,random-walk,N2,1,18797,19696,38493,4676,15.0
kroB200.tsp,greedy-cycle,random-walk,N2,160,20257,18102,38359,2,15.0
kroB200.tsp,candidate-ls,random-walk,N2,77,20954,18901,39855,1475,15.0
kroA200.tsp,qc-ls,random-walk,N2,16,18597,22189,40786,315,15.0
kroA200.tsp,steepest-ls,random-walk,N2,37,18039,20610,38649,4617,15.0
kroB200.tsp,qc-ls,random-walk,N2,63,22628,21220,43848,338,15.0
kroB200.tsp,candidate-ls,random-walk,N2,6,19856,19100,38956,1488,15.0
kroA200.tsp,greedy-cycle,random-walk,N2,186,17458,22307,39765,2,15.0
kroB200.tsp,candidate-ls,random-walk,N2,140,20683,20037,40720,1431,15.0
kroA200.tsp,steepest-ls,random-walk,N2,176,19398,21011,40409,4276,15.0
kroB200.tsp,greedy-cycle,random-walk,N2,68,18449,21333,39782,3,15.0
kroB200.tsp,greedy-cycle,random-walk,N2,87,17701,20396,38097,2,15.0
kroA200.tsp,qc-ls,random-walk,N2,41,21287,22279,43566,316,15.0
kroB200.tsp,candidate-ls,random-walk,N2,20,20571,19121,39692,1317,15.0
kroB200.tsp,qc-ls,random-walk,N2,2,18624,22988,41612,331,15.0
kroB200.tsp,qc-ls,random-walk,N2,126,19379,19690,39069,508,15.0
kroB200.tsp,qc-ls,random-walk,N2,18,20847,22643,43490,299,15.0
kroB200.tsp,queue-ls,random-walk,N2,75,22766,19275,42041,461,15.0
kroA200.tsp,queue-ls,random-walk,N2,55,20631,20070,40701,397,15.0
kroA200.tsp,greedy-cycle,random-walk,N2,34,18327,19625,37952,2,15.0
kroB200.tsp,queue-ls,random-walk,N2,158,23907,21675,45582,337,15.0
kroA200.tsp,candidate-ls,random-walk,N2,93,18332,20413,38745,1572,15.0
kroA200.tsp,greedy-cycle,random-walk,N2,112,17402,18062,35464,6,15.0
kroA200.tsp,queue-ls,random-walk,N2,136,23223,20545,43768,391,15.0
kroB200.tsp,steepest-ls,random-walk,N2,20,19587,20150,39737,4245,15.0
kroA200.tsp,steepest-ls,random-walk,N2,8,19626,19177,38803,4936,15.0
kroA200.tsp,greedy-cycle,random-walk,N2,8,18388,17472,35860,2,15.0
kroA200.tsp,queue-ls,random-walk,N2,4,20413,22300,42713,337,15.0
kroB200.tsp,greedy-cycle,random-walk,N2,13,20857,18065,38922,2,15.0
kroA200.tsp,greedy-cycle,random-walk,N2,63,16452,21633,38085,2,15.0
kroB200.tsp,queue-ls,random-walk,N2,22,19401,18163,37564,352,15.0
kroB200.tsp,steepest-ls,random-walk,N2,192,18943,20877,39820,4669,15.0
kroA200.tsp,qc-ls,random-walk,N2,7,27486,22960,50446,287,15.0
kroB200.tsp,steepest-ls,random-walk,N2,77,19052,19573,38625,4800,15.0
kroA200.tsp,qc-ls,random-walk,N2,82,19332,18794,38126,339,15.0
kroB200.tsp,greedy-cycle,random-walk,N2,44,18987,16849,35836,4,15.0
kroA200.tsp,candidate-ls,random-walk,N2,132,18142,18874,37016,2146,15.0
kroA200.tsp,qc-ls,random-walk,N2,176,21654,19686,41340,412,15.0
kroB200.tsp,steepest-ls,random-walk,N2,98,20346,19077,39423,4376,15.0
kroB200.tsp,qc-ls,random-walk,N2,59,19286,21845,41131,346,15.0
kroB200.tsp,queue-ls,random-walk,N2,34,20646,21602,42248,327,15.0
kroB200.tsp,queue-ls,random-walk,N2,5,20793,20606,41399,360,15.0
kroA200.tsp,queue-ls,random-walk,N2,14,20195,22761,42956,358,15.0
kroA200.tsp,greedy-cycle,random-walk,N2,75,17669,22204,39873,2,15.0
kroB200.tsp,steepest-ls,random-walk,N2,184,19066,19292,38358,4729,15.0
kroB200.tsp,steepest-ls,random-walk,N2,61,19324,18174,37498,4817,15.0
kroA200.tsp,qc-ls,random-walk,N2,160,20872,20287,41159,386,15.0
kroA200.tsp,candidate-ls,random-walk,N2,124,19150,18895,38045,1795,15.0
kroA200.tsp,queue-ls,random-walk,N2,198,22407,21094,43501,321,15.0
kroB200.tsp,greedy-cycle,random-walk,N2,52,18256,21333,39589,3,15.0
kroA200.tsp,qc-ls,random-walk,N2,94,21505,19172,40677,331,15.0
kroA200.tsp,candidate-ls,random-walk,N2,85,18841,19206,38047,1432,15.0
kroA200.tsp,greedy-cycle,random-walk,N2,22,17669,22204,39873,5,15.0
kroA200.tsp,queue-ls,random-walk,N2,43,23870,21907,45777,301,15.0
kroB200.tsp,queue-ls,random-walk,N2,63,22954,22526,45480,358,15.0
kroA200.tsp,greedy-cycle,random-walk,N2,104,18193,21615,39808,3,15.0
kroA200.tsp,candidate-ls,random-walk,N2,7,18039,20893,38932,1548,15.0
kroB200.tsp,steepest-ls,random-walk,N2,36,19177,19081,38258,4651,15.0
kroA200.tsp,queue-ls,random-walk,N2,120,24771,24153,48924,286,15.0
kroA200.tsp,candidate-ls,random-walk,N2,6,20737,19091,39828,1408,15.0
kroB200.tsp,steepest-ls,random-walk,N2,37,18240,20628,38868,4677,15.0
kroA200.tsp,candidate-ls,random-walk,N2,172,20052,17796,37848,1515,15.0
kroA200.tsp,qc-ls,random-walk,N2,136,18919,19878,38797,443,15.0
kroA200.tsp,candidate-ls,random-walk,N2,84,17442,20374,37816,1494,15.0
kroA200.tsp,greedy-cycle,random-walk,N2,23,18374,17472,35846,3,15.0
kroA200.tsp,queue-ls,random-walk,N2,42,20079,19656,39735,318,15.0
kroB200.tsp,queue-ls,random-walk,N2,62,19983,21435,41418,358,15.0
kroA200.tsp,queue-ls,random-walk,N2,176,26348,24588,50936,326,15.0
kroB200.tsp,steepest-ls,random-walk,N2,60,19423,19343,38766,4762,15.0
kroB200.tsp,greedy-cycle,random-walk,N2,53,17634,20396,38030,2,15.0
kroA200.tsp,qc-ls,random-walk,N2,95,21493,20311,41804,347,15.0
kroB200.tsp,qc-ls,random-walk,N2,58,19269,19176,38445,314,15.0
kroB200.tsp,queue-ls,random-walk,N2,4,22511,23342,45853,327,15.0
kroB200.tsp,queue-ls,random-walk,N2,35,21125,18950,40075,387,15.0
kroA200.tsp,queue-ls,random-walk,N2,15,20669,24319,44988,421,15.0
kroA200.tsp,greedy-cycle,random-walk,N2,74,16553,22671,39224,2,15.0
kroB200.tsp,queue-ls,random-walk,N2,118,20203,20986,41189,331,15.0
kroB200.tsp,candidate-ls,random-walk,N2,194,20016,18879,38895,1497,15.0
kroA200.tsp,greedy-cycle,random-walk,N2,152,21564,18253,39817,3,15.0
kroB200.tsp,steepest-ls,random-walk,N2,76,20391,18017,38408,4601,15.0
kroA200.tsp,qc-ls,random-walk,N2,198,21690,21542,43232,338,15.0
kroA200.tsp,queue-ls,random-walk,N2,160,22124,19570,41694,369,15.0
kroA200.tsp,qc-ls,random-walk,N2,83,21364,24413,45777,352,15.0
kroB200.tsp,greedy-cycle,random-walk,N2,45,16972,21859,38831,2,15.0
kroB200.tsp,steepest-ls,random-walk,N2,99,20719,20538,41257,4495,15.0
kroA200.tsp,greedy-cycle,random-walk,N2,62,21596,18253,39849,5,15.0
kroB200.tsp,queue-ls,random-walk,N2,23,28893,21910,50803,335,15.0
kroA200.tsp,greedy-cycle,random-walk,N2,144,18444,18709,37153,2,15.0
kroA200.tsp,qc-ls,random-walk,N2,6,19521,18855,38376,374,15.0
kroB200.tsp,candidate-ls,random-walk,N2,182,19552,19665,39217,1504,15.0
kroB200.tsp,steepest-ls,random-walk,N2,21,18111,21130,39241,4634,15.0
kroA200.tsp,steepest-ls,random-walk,N2,9,20032,17787,37819,4825,15.0
kroA200.tsp,qc-ls,random-walk,N2,120,20627,20208,40835,395,15.0
kroA200.tsp,greedy-cycle,random-walk,N2,9,21703,18093,39796,2,15.0
kroA200.tsp,candidate-ls,random-walk,N2,164,20571,19378,39949,1546,15.0
kroA200.tsp,queue-ls,random-walk,N2,5,21378,18377,39755,453,15.0
kroB200.tsp,greedy-cycle,random-walk,N2,12,21562,18065,39627,2,15.0
kroB200.tsp,qc-ls,random-walk,N2,19,19263,21508,40771,561,15.0
kroB200.tsp,queue-ls,random-walk,N2,74,21849,18499,40348,340,15.0
kroA200.tsp,queue-ls,random-walk,N2,54,19414,18847,38261,346,15.0
kroA200.tsp,greedy-cycle,random-walk,N2,35,20643,18253,38896,2,15.0
kroA200.tsp,candidate-ls,random-walk,N2,92,19758,21447,41205,1387,15.0
kroB200.tsp,greedy-cycle,random-walk,N2,69,18256,21333,39589,2,15.0
kroB200.tsp,greedy-cycle,random-walk,N2,86,19202,20010,39212,3,15.0
kroA200.tsp,qc-ls,random-walk,N2,40,19089,18315,37404,336,15.0
kroB200.tsp,candidate-ls,random-walk,N2,21,20181,18270,38451,1788,15.0
kroB200.tsp,greedy-cycle,random-walk,N2,136,17606,20396,38002,3,15.0
kroB200.tsp,qc-ls,random-walk,N2,3,20490,19970,40460,364,15.0
kroA200.tsp,steepest-ls,random-walk,N2,198,19749,18573,38322,4802,15.0
kroA200.tsp,greedy-cycle,random-walk,N2,168,18327,19625,37952,2,15.0
kroB200.tsp,qc-ls,random-walk,N2,62,27603,29509,57112,219,15.0
kroA200.tsp,steepest-ls,random-walk,N2,36,19755,18401,38156,4838,15.0
kroB200.tsp,candidate-ls,random-walk,N2,7,19689,19282,38971,1592,15.0
kroB200.tsp,steepest-ls,random-walk,N2,150,18063,19845,37908,4825,15.0
kroB200.tsp,queue-ls,random-walk,N2,122,23901,23583,47484,326,15.0
kroB200.tsp,candidate-ls,random-walk,N2,99,20786,18728,39514,1632,15.0
kroA200.tsp,candidate-ls,random-walk,N2,148,18671,20699,39370,1484,15.0
kroA200.tsp,steepest-ls,random-walk,N2,120,19630,18021,37651,4496,15.0
kroB200.tsp,qc-ls,random-walk,N2,170,20662,19784,40446,375,15.0
kroB200.tsp,candidate-ls,random-walk,N2,76,20516,18218,38734,1428,15.0
kroA200.tsp,qc-ls,random-walk,N2,17,20468,19019,39487,429,15.0
kroA200.tsp,queue-ls,random-walk,N2,97,21872,21326,43198,359,15.0
kroA200.tsp,candidate-ls,random-walk,N2,51,20497,20014,40511,1439,15.0
kroA200.tsp,greedy-cycle,random-walk,N2,19,16452,21633,38085,2,15.0
kroB200.tsp,candidate-ls,random-walk,N2,116,21557,19073,40630,1498,15.0
kroA200.tsp,queue-ls,random-walk,N2,78,20976,23220,44196,304,15.0
kroB200.tsp,queue-ls,random-walk,N2,58,20994,21665,42659,317,15.0
kroB200.tsp,qc-ls,random-walk,N2,35,21579,22544,44123,323,15.0
kroA200.tsp,steepest-ls,random-walk,N2,61,18468,19396,37864,4717,15.0
kroA200.tsp,steepest-ls,random-walk,N2,136,19405,18640,38045,4806,15.0
kroB200.tsp,greedy-cycle,random-walk,N2,198,18034,20453,38487,3,15.0
kroB200.tsp,greedy-cycle,random-walk,N2,28,20711,18141,38852,2,15.0
kroB200.tsp,candidate-ls,random-walk,N2,60,18926,19221,38147,1441,15.0
kroA200.tsp,greedy-cycle,random-walk,N2,200,17951,19455,37406,2,15.0
kroB200.tsp,qc-ls,random-walk,N2,166,19809,20267,40076,432,15.0
kroA200.tsp,candidate-ls,random-walk,N2,47,19736,19342,39078,1587,15.0
kroA200.tsp,queue-ls,random-walk,N2,81,21176,19951,41127,321,15.0
kroA200.tsp,steepest-ls,random-walk,N2,98,21159,19272,40431,4861,15.0
kroA200.tsp,steepest-ls,random-walk,N2,77,19509,20574,40083,4659,15.0
kroB200.tsp,qc-ls,random-walk,N2,23,21517,22287,43804,334,15.0
kroB200.tsp,candidate-ls,random-walk,N2,100,20574,19123,39697,1430,15.0
kroB200.tsp,greedy-cycle,random-walk,N2,120,20853,18065,38918,4,15.0
kroB200.tsp,candidate-ls,random-walk,N2,37,19789,19085,38874,1423,15.0
kroA200.tsp,qc-ls,random-walk,N2,56,21050,21386,42436,332,15.0
kroB200.tsp,greedy-cycle,random-walk,N2,90,20595,18141,38736,3,15.0
kroB200.tsp,greedy-cycle,random-walk,N2,8,16995,21859,38854,2,15.0
kroA200.tsp,candidate-ls,random-walk,N2,10,17738,18862,36600,1481,15.0
kroB200.tsp,queue-ls,random-walk,N2,134,21421,19329,40750,373,15.0
kroA200.tsp,greedy-cycle,random-walk,N2,58,18893,20745,39638,2,15.0
kroB200.tsp,steepest-ls,random-walk,N2,146,18098,19886,37984,4558,15.0
kroA200.tsp,queue-ls,random-walk,N2,39,26279,24943,51222,285,15.0
kroB200.tsp,queue-ls,random-walk,N2,19,19892,19927,39819,434,15.0
kroA200.tsp,steepest-ls,random-walk,N2,20,19888,20689,40577,4427,15.0
kroB200.tsp,qc-ls,random-walk,N2,74,23732,19804,43536,290,15.0
kroA200.tsp,steepest-ls,random-walk,N2,57,18903,19497,38400,4611,15.0
kroB200.tsp,candidate-ls,random-walk,N2,120,18637,19889,38526,1634,15.0
kroA200.tsp,candidate-ls,random-walk,N2,88,19707,19570,39277,1352,15.0
kroA200.tsp,candidate-ls,random-walk,N2,67,19796,19028,38824,1353,15.0
kroB200.tsp,queue-ls,random-walk,N2,81,24246,22678,46924,360,15.0
kroA200.tsp,qc-ls,random-walk,N2,21,21199,19277,40476,353,15.0
kroB200.tsp,candidate-ls,random-walk,N2,40,19034,19455,38489,1476,15.0
kroB200.tsp,qc-ls,random-walk,N2,146,20609,19429,40038,634,15.0
kroA200.tsp,steepest-ls,random-walk,N2,116,19087,19017,38104,4737,15.0
kroA200.tsp,candidate-ls,random-walk,N2,200,18711,20050,38761,1573,15.0
kroB200.tsp,queue-ls,random-walk,N2,114,19848,20315,40163,403,15.0
kroA200.tsp,greedy-cycle,random-walk,N2,78,16626,21633,38259,3,15.0
kroB200.tsp,steepest-ls,random-walk,N2,166,19197,19315,38512,4838,15.0
kroA200.tsp,queue-ls,random-walk,N2,19,21091,23236,44327,359,15.0
kroB200.tsp,queue-ls,random-walk,N2,39,19544,19105,38649,705,15.0
kroB200.tsp,queue-ls,random-walk,N2,8,23555,27559,51114,276,15.0
kroB200.tsp,qc-ls,random-walk,N2,54,20031,18909,38940,336,15.0
kroB200.tsp,candidate-ls,random-walk,N2,198,21219,20676,41895,1567,15.0
kroA200.tsp,greedy-cycle,random-walk,N2,97,16990,20167,37157,2,15.0
kroA200.tsp,candidate-ls,random-walk,N2,30,19962,19896,39858,1416,15.0
kroB200.tsp,greedy-cycle,random-walk,N2,100,18449,21333,39782,6,15.0
kroA200.tsp,qc-ls,random-walk,N2,182,22393,20082,42475,363,15.0
kroB200.tsp,candidate-ls,random-walk,N2,17,20259,17955,38214,1622,15.0
kroA200.tsp,qc-ls,random-walk,N2,76,20779,18822,39601,331,15.0
kroA200.tsp,qc-ls,random-walk,N2,99,21407,20973,42380,378,15.0
kroB200.tsp,steepest-ls,random-walk,N2,83,18293,22270,40563,4467,15.0
kroB200.tsp,qc-ls,random-walk,N2,42,22548,22619,45167,310,15.0
kroA200.tsp,steepest-ls,random-walk,N2,16,19365,20717,40082,4708,15.0
kroB200.tsp,steepest-ls,random-walk,N2,170,20315,18580,38895,4582,15.0
kroB200.tsp,queue-ls,random-walk,N2,102,23618,24001,47619,267,15.0
kroA200.tsp,candidate-ls,random-walk,N2,26,20620,19225,39845,1392,15.0
kroA200.tsp,greedy-cycle,random-walk,N2,81,18388,17472,35860,2,15.0
kroA200.tsp,greedy-cycle,random-walk,N2,148,21345,18253,39598,2,15.0
kroA200.tsp,qc-ls,random-walk,N2,60,22197,22439,44636,320,15.0
kroA200.tsp,qc-ls,random-walk,N2,194,19522,19092,38614,639,15.0
kroB200.tsp,greedy-cycle,random-walk,N2,116,18352,21333,39685,5,15.0
kroB200.tsp,steepest-ls,random-walk,N2,95,19262,20076,39338,4956,15.0
kroB200.tsp,greedy-cycle,random-walk,N2,49,17891,20396,38287,2,15.0
kroA200.tsp,greedy-cycle,random-walk,N2,39,18201,17472,35673,2,15.0
kroB200.tsp,candidate-ls,random-walk,N2,136,18807,19521,38328,1444,15.0
kroA200.tsp,queue-ls,random-walk,N2,58,20997,19567,40564,332,15.0
kroB200.tsp,queue-ls,random-walk,N2,78,21366,19386,40752,337,15.0
kroB200.tsp,qc-ls,random-walk,N2,15,20320,19957,40277,378,15.0
kroA200.tsp,steepest-ls,random-walk,N2,41,20825,18074,38899,4852,15.0
kroB200.tsp,queue-ls,random-walk,N2,97,26061,25347,51408,291,15.0
kroA200.tsp,candidate-ls,random-walk,N2,71,17526,20071,37597,1600,15.0
kroB200.tsp,qc-ls,random-walk,N2,150,20981,21304,42285,492,15.0
kroB200.tsp,candidate-ls,random-walk,N2,56,18793,19997,38790,1375,15.0
kroA200.tsp,qc-ls,random-walk,N2,37,20620,22314,42934,326,15.0
kroA200.tsp,queue-ls,random-walk,N2,9,20956,19547,40503,325,15.0
kroA200.tsp,candidate-ls,random-walk,N2,168,20790,17830,38620,1528,15.0
kroA200.tsp,greedy-cycle,random-walk,N2,5,17458,22307,39765,2,15.0
kroA200.tsp,steepest-ls,random-walk,N2,5,19253,19559,38812,4992,15.0
kroA200.tsp,steepest-ls,random-walk,N2,100,17883,20079,37962,4752,15.0
kroB200.tsp,qc-ls,random-walk,N2,81,22983,22170,45153,327,15.0
kroA200.tsp,greedy-cycle,random-walk,N2,164,21218,17365,38583,2,15.0
kroA200.tsp,greedy-cycle,random-walk,N2,42,18193,21615,39808,4,15.0
kroA200.tsp,queue-ls,random-walk,N2,23,20790,22773,43563,383,15.0
kroB200.tsp,greedy-cycle,random-walk,N2,65,17855,20510,38365,2,15.0
kroB200.tsp,steepest-ls,random-walk,N2,56,19913,18485,38398,4485,15.0
kroA200.tsp,steepest-ls,random-walk,N2,194,18948,20194,39142,4502,15.0
kroA200.tsp,queue-ls,random-walk,N2,140,19502,18611,38113,563,15.0
kroB200.tsp,queue-ls,random-walk,N2,196,18167,22317,40484,403,15.0
kroA200.tsp,steepest-ls,random-walk,N2,82,20422,17177,37599,4885,15.0
kroB200.tsp,qc-ls,random-walk,N2,39,21551,19857,41408,348,15.0
kroB200.tsp,queue-ls,random-walk,N2,54,27210,26190,53400,244,15.0
kroA200.tsp,queue-ls,random-walk,N2,74,21603,21751,43354,310,15.0
kroA200.tsp,greedy-cycle,random-walk,N2,15,18187,17472,35659,2,15.0
kroA200.tsp,qc-ls,random-walk,N2,100,20472,20629,41101,310,15.0
kroB200.tsp,greedy-cycle,random-walk,N2,182,17742,20268,38010,3,15.0
kroA200.tsp,candidate-ls,random-walk,N2,144,19578,20134,39712,1534,15.0
kroB200.tsp,candidate-ls,random-walk,N2,95,18937,18414,37351,1645,15.0
kroB200.tsp,greedy-cycle,random-walk,N2,32,21676,18649,40325,4,15.0
kroA200.tsp,steepest-ls,random-walk,N2,94,19511,17876,37387,4580,15.0
kroB200.tsp,queue-ls,random-walk,N2,180,22452,23138,45590,378,15.0
kroA200.tsp,queue-ls,random-walk,N2,62,20925,23385,44310,318,15.0
kroB200.tsp,queue-ls,random-walk,N2,42,19627,18359,37986,372,15.0
kroB200.tsp,greedy-cycle,random-walk,N2,24,16972,21859,38831,2,15.0
kroB200.tsp,candidate-ls,random-walk,N2,83,18847,20435,39282,1615,15.0
kroA200.tsp,candidate-ls,random-walk,N2,152,19390,20690,40080,1648,15.0
kroB200.tsp,greedy-cycle,random-walk,N2,194,21184,18065,39249,2,15.0
kroA200.tsp,qc-ls,random-walk,N2,116,19032,20561,39593,400,15.0
kroB200.tsp,steepest-ls,random-walk,N2,17,18697,19524,38221,4862,15.0
kroA200.tsp,greedy-cycle,random-walk,N2,172,17669,22204,39873,3,15.0
kroB200.tsp,greedy-cycle,random-walk,N2,4,18449,21333,39782,2,15.0
kroB200.tsp,qc-ls,random-walk,N2,97,19214,18771,37985,356,15.0
kroB200.tsp,qc-ls,random-walk,N2,78,23482,21243,44725,275,15.0
kroB200.tsp,queue-ls,random-walk,N2,15,22269,20898,43167,405,15.0
kroA200.tsp,queue-ls,random-walk,N2,35,22801,20860,43661,327,15.0
kroA200.tsp,greedy-cycle,random-walk,N2,54,16614,21633,38247,2,15.0
kroB200.tsp,queue-ls,random-walk,N2,138,20860,20550,41410,370,15.0
kroB200.tsp,greedy-cycle,random-walk,N2,73,17855,20510,38365,2,15.0
kroA200.tsp,queue-ls,random-walk,N2,156,21700,18996,40696,354,15.0
kroA200.tsp,steepest-ls,random-walk,N2,182,18590,18624,37214,4603,15.0
kroB200.tsp,steepest-ls,random-walk,N2,40,18573,20608,39181,4363,15.0
kroB200.tsp,queue-ls,random-walk,N2,82,19982,22082,42064,312,15.0
kroA200.tsp,candidate-ls,random-walk,N2,64,18333,20416,38749,1362,15.0
kroB200.tsp,queue-ls,random-walk,N2,140,21728,20726,42454,641,15.0
kroA200.tsp,steepest-ls,random-walk,N2,54,19742,19460,39202,4413,15.0
kroB200.tsp,steepest-ls,random-walk,N2,132,18939,19119,38058,5168,15.0
kroB200.tsp,greedy-cycle,random-walk,N2,154,21486,18065,39551,3,15.0
kroB200.tsp,steepest-ls,random-walk,N2,38,19106,21037,40143,4330,15.0
kroA200.tsp,candidate-ls,random-walk,N2,9,19089,19985,39074,1437,15.0
kroA200.tsp,qc-ls,random-walk,N2,22,20932,21477,42409,314,15.0
kroA200.tsp,candidate-ls,random-walk,N2,192,19695,21800,41495,1474,15.0
kroB200.tsp,candidate-ls,random-walk,N2,43,20044,19275,39319,1553,15.0
kroA200.tsp,greedy-cycle,random-walk,N2,94,17926,22204,40130,4,15.0
kroA200.tsp,candidate-ls,random-walk,N2,33,19496,20014,39510,1383,15.0
kroB200.tsp,qc-ls,random-walk,N2,57,18789,18826,37615,381,15.0
kroB200.tsp,candidate-ls,random-walk,N2,174,18327,20404,38731,1577,15.0
kroB200.tsp,steepest-ls,random-walk,N2,80,18854,20302,39156,4364,15.0
kroA200.tsp,steepest-ls,random-walk,N2,142,20867,18384,39251,4811,15.0
kroA200.tsp,queue-ls,random-walk,N2,196,24971,22639,47610,343,15.0
kroB200.tsp,candidate-ls,random-walk,N2,14,18226,19457,37683,1504,15.0
kroA200.tsp,qc-ls,random-walk,N2,75,19410,21749,41159,363,15.0
kroB200.tsp,qc-ls,random-walk,N2,112,20727,21283,42010,616,15.0
kroA200.tsp,candidate-ls,random-walk,N2,25,19191,20959,40150,1412,15.0
kroA200.tsp,greedy-cycle,random-walk,N2,82,17202,20167,37369,3,15.0
kroA200.tsp,qc-ls,random-walk,N2,9,24294,23873,48167,479,15.0
kroB200.tsp,candidate-ls,random-walk,N2,162,18919,21292,40211,1529,15.0
kroB200.tsp,qc-ls,random-walk,N2,41,19673,21768,41441,343,15.0
kroA200.tsp,steepest-ls,random-walk,N2,15,20084,17108,37192,5037,15.0
kroA200.tsp,queue-ls,random-walk,N2,180,21325,21631,42956,428,15.0
kroA200.tsp,steepest-ls,random-walk,N2,154,19434,19513,38947,4997,15.0
kroB200.tsp,steepest-ls,random-walk,N2,96,18856,19196,38052,4604,15.0
kroA200.tsp,qc-ls,random-walk,N2,178,25220,21338,46558,330,15.0
kroB200.tsp,steepest-ls,random-walk,N2,79,19825,18293,38118,4722,15.0
kroB200.tsp,qc-ls,random-walk,N2,104,25110,27125,52235,301,15.0
kroA200.tsp,qc-ls,random-walk,N2,63,18565,19191,37756,391,15.0
kroA200.tsp,candidate-ls,random-walk,N2,72,18582,18772,37354,1528,15.0
kroB200.tsp,queue-ls,random-walk,N2,94,23216,18476,41692,315,15.0
kroB200.tsp,steepest-ls,random-walk,N2,124,19092,18830,37922,4771,15.0
kroB200.tsp,qc-ls,random-walk,N2,16,20559,19145,39704,325,15.0
kroA200.tsp,steepest-ls,random-walk,N2,42,20324,18698,39022,5030,15.0
kroB200.tsp,queue-ls,random-walk,N2,156,19781,23287,43068,402,15.0
kroA200.tsp,greedy-cycle,random-walk,N2,6,18273,17472,35745,2,15.0
kroA200.tsp,steepest-ls,random-walk,N2,6,20645,19750,40395,4767,15.0
kroB200.tsp,candidate-ls,random-walk,N2,55,19752,20246,39998,1611,15.0
kroA200.tsp,candidate-ls,random-walk,N2,184,19791,19301,39092,1603,15.0
kroA200.tsp,queue-ls,random-walk,N2,138,33356,27426,60782,265,15.0
kroA200.tsp,qc-ls,random-walk,N2,34,23154,25726,48880,268,15.0
kroB200.tsp,greedy-cycle,random-walk,N2,142,17701,20396,38097,2,15.0
kroA200.tsp,greedy-cycle,random-walk,N2,188,21416,18093,39509,5,15.0
kroA200.tsp,queue-ls,random-walk,N2,20,19676,19555,39231,369,15.0
kroB200.tsp,candidate-ls,random-walk,N2,8,19476,20437,39913,1356,15.0
kroA200.tsp,steepest-ls,random-walk,N2,39,18840,19843,38683,4707,15.0
kroA200.tsp,greedy-cycle,random-walk,N2,41,16614,21633,38247,2,15.0
kroB200.tsp,qc-ls,random-walk,N2,82,21246,18283,39529,332,15.0
kroB200.tsp,greedy-cycle,random-walk,N2,89,16866,22271,39137,2,15.0
kroB200.tsp,qc-ls,random-walk,N2,128,21520,21170,42690,313,15.0
kroB200.tsp,steepest-ls,random-walk,N2,55,19556,18043,37599,4820,15.0
kroA200.tsp,qc-ls,random-walk,N2,154,23105,23884,46989,319,15.0
kroA200.tsp,steepest-ls,random-walk,N2,178,18817,18232,37049,4505,15.0
kroB200.tsp,greedy-cycle,random-walk,N2,66,18520,21333,39853,4,15.0
kroA200.tsp,candidate-ls,random-walk,N2,110,19835,18103,37938,1546,15.0
kroA200.tsp,greedy-cycle,random-walk,N2,16,16943,20139,37082,6,15.0
kroB200.tsp,queue-ls,random-walk,N2,57,20926,18775,39701,423,15.0
kroB200.tsp,steepest-ls,random-walk,N2,108,20019,18963,38982,4771,15.0
kroA200.tsp,queue-ls,random-walk,N2,77,21605,21950,43555,353,15.0
kroA200.tsp,queue-ls,random-walk,N2,98,19899,20714,40613,337,15.0
kroA200.tsp,greedy-cycle,random-walk,N2,130,21332,18093,39425,7,15.0
kroA200.tsp,steepest-ls,random-walk,N2,81,19649,19162,38811,4704,15.0
kroA200.tsp,qc-ls,random-walk,N2,18,28795,29214,58009,260,15.0
kroA200.tsp,queue-ls,random-walk,N2,114,20869,21023,41892,324,15.0
kroB200.tsp,candidate-ls,random-walk,N2,79,19042,18911,37953,1548,15.0
kroB200.tsp,candidate-ls,random-walk,N2,96,17800,22191,39991,1324,15.0
kroB200.tsp,greedy-cycle,random-walk,N2,31,20210,18102,38312,3,15.0
kroB200.tsp,qc-ls,random-walk,N2,190,19316,18260,37576,409,15.0
kroA200.tsp,queue-ls,random-walk,N2,61,24801,28212,53013,326,15.0
kroB200.tsp,queue-ls,random-walk,N2,41,25178,26330,51508,342,15.0
kroA200.tsp,steepest-ls,random-walk,N2,78,19373,18459,37832,4808,15.0
kroA200.tsp,candidate-ls,random-walk,N2,48,20183,18154,38337,1461,15.0
kroA200.tsp,steepest-ls,random-walk,N2,97,18023,19455,37478,4961,15.0
kroA200.tsp,greedy-cycle,random-walk,N2,126,16614,21633,38247,6,15.0
kroA200.tsp,queue-ls,random-walk,N2,102,20500,19554,40054,383,15.0
kroB200.tsp,steepest-ls,random-walk,N2,14,20617,20524,41141,4436,15.0
kroB200.tsp,greedy-cycle,random-walk,N2,178,18048,20656,38704,2,15.0
kroB200.tsp,qc-ls,random-walk,N2,186,20219,21317,41536,520,15.0
kroB200.tsp,greedy-cycle,random-walk,N2,27,20595,18141,38736,8,15.0
kroB200.tsp,candidate-ls,random-walk,N2,80,20030,20020,40050,1402,15.0
kroA200.tsp,greedy-cycle,random-walk,N2,57,17168,20167,37335,4,15.0
kroB200.tsp,candidate-ls,random-walk,N2,158,21204,20191,41395,1387,15.0
kroB200.tsp,queue-ls,random-walk,N2,16,21009,21122,42131,362,15.0
kroA200.tsp,queue-ls,random-walk,N2,36,23108,23021,46129,310,15.0
kroB200.tsp,greedy-cycle,random-walk,N2,7,20711,18141,38852,2,15.0
kroB200.tsp,qc-ls,random-walk,N2,94,19940,23258,43198,307,15.0
kroB200.tsp,steepest-ls,random-walk,N2,43,19289,19755,39044,4681,15.0
kroA200.tsp,qc-ls,random-walk,N2,59,20555,19106,39661,336,15.0
kroB200.tsp,candidate-ls,random-walk,N2,38,20177,19344,39521,1362,15.0
kroA200.tsp,candidate-ls,random-walk,N2,106,19957,19568,39525,1631,15.0
kroB200.tsp,greedy-cycle,random-walk,N2,70,20373,18102,38475,2,15.0
kroA200.tsp,qc-ls,random-walk,N2,142,20466,21011,41477,605,15.0
kroA200.tsp,queue-ls,random-walk,N2,122,20520,19851,40371,396,15.0
kroA200.tsp,candidate-ls,random-walk,N2,5,20026,18965,38991,1564,15.0
kroB200.tsp,steepest-ls,random-walk,N2,34,17684,20829,38513,4724,15.0
kroB200.tsp,greedy-cycle,random-walk,N2,158,17825,20246,38071,2,15.0
kroA200.tsp,candidate-ls,random-walk,N2,68,19020,18703,37723,1458,15.0
kroA200.tsp,greedy-cycle,random-walk,N2,106,17458,22307,39765,3,15.0
kroA200.tsp,queue-ls,random-walk,N2,41,22790,22633,45423,315,15.0
kroB200.tsp,queue-ls,random-walk,N2,61,22552,26615,49167,564,15.0
kroA200.tsp,steepest-ls,random-walk,N2,58,19119,16977,36096,4457,15.0
kroA200.tsp,candidate-ls,random-walk,N2,87,20217,19094,39311,1525,15.0
kroA200.tsp,greedy-cycle,random-walk,N2,20,17722,22204,39926,2,15.0
kroA200.tsp,candidate-ls,random-walk,N2,126,19809,19895,39704,1939,15.0
kroB200.tsp,greedy-cycle,random-walk,N2,50,21450,18385,39835,3,15.0
kroA200.tsp,qc-ls,random-walk,N2,96,24324,22288,46612,281,15.0
kroA200.tsp,qc-ls,random-walk,N2,162,19900,18971,38871,410,15.0
kroB200.tsp,steepest-ls,random-walk,N2,63,20193,18380,38573,4854,15.0
kroA200.tsp,qc-ls,random-walk,N2,79,20559,19096,39655,379,15.0
kroB200.tsp,candidate-ls,random-walk,N2,18,18855,20029,38884,1431,15.0
kroB200.tsp,steepest-ls,random-walk,N2,186,18321,19882,38203,4699,15.0
kroA200.tsp,greedy-cycle,random-walk,N2,98,21703,18093,39796,3,15.0
kroA200.tsp,greedy-cycle,random-walk,N2,77,18388,17472,35860,2,15.0
kroB200.tsp,candidate-ls,random-walk,N2,178,19899,20045,39944,1335,15.0
kroB200.tsp,queue-ls,random-walk,N2,7,21732,20437,42169,367,15.0
kroB200.tsp,queue-ls,random-walk,N2,36,20645,21343,41988,316,15.0
kroA200.tsp,queue-ls,random-walk,N2,16,23838,25369,49207,259,15.0
kroA200.tsp,qc-ls,random-walk,N2,174,26903,28539,55442,279,15.0
kroA200.tsp,steepest-ls,random-walk,N2,158,19186,18818,38004,4935,15.0
kroA200.tsp,qc-ls,random-walk,N2,80,22495,23995,46490,274,15.0
kroB200.tsp,greedy-cycle,random-walk,N2,46,17895,20656,38551,4,15.0
kroA200.tsp,candidate-ls,random-walk,N2,130,18942,19808,38750,2016,15.0
kroB200.tsp,qc-ls,random-walk,N2,108,22048,20964,43012,610,15.0
kroB200.tsp,steepest-ls,random-walk,N2,75,21271,19616,40887,4601,15.0
kroA200.tsp,qc-ls,random-walk,N2,5,19846,18991,38837,411,15.0
kroA200.tsp,candidate-ls,random-walk,N2,29,18920,19565,38485,1437,15.0
kroB200.tsp,steepest-ls,random-walk,N2,190,18142,19849,37991,4855,15.0
kroB200.tsp,queue-ls,random-walk,N2,20,18225,20864,39089,338,15.0
kroA200.tsp,steepest-ls,random-walk,N2,19,20376,20029,40405,4863,15.0
kroA200.tsp,greedy-cycle,random-walk,N2,61,17202,20167,37369,2,15.0
kroA200.tsp,queue-ls,random-walk,N2,6,25654,23079,48733,311,15.0
kroB200.tsp,greedy-cycle,random-walk,N2,11,20257,18102,38359,2,15.0
kroB200.tsp,steepest-ls,random-walk,N2,22,19308,18073,37381,4558,15.0
kroA200.tsp,qc-ls,random-walk,N2,38,20916,24879,45795,293,15.0
kroA200.tsp,queue-ls,random-walk,N2,134,20033,21927,41960,382,15.0
kroA200.tsp,candidate-ls,random-walk,N2,188,20049,19861,39910,1535,15.0
kroB200.tsp,candidate-ls,random-walk,N2,59,18872,19611,38483,1629,15.0
kroA200.tsp,greedy-cycle,random-walk,N2,110,17362,18993,36355,3,15.0
kroB200.tsp,queue-ls,random-walk,N2,98,20371,20109,40480,327,15.0
kroA200.tsp,greedy-cycle,random-walk,N2,36,18068,17472,35540,2,15.0
kroA200.tsp,candidate-ls,random-walk,N2,91,17214,20715,37929,1456,15.0
kroB200.tsp,queue-ls,random-walk,N2,77,25386,21973,47359,348,15.0
kroB200.tsp,steepest-ls,random-walk,N2,128,19068,18623,37691,5246,15.0
kroA200.tsp,queue-ls,random-walk,N2,57,24589,23067,47656,339,15.0
kroB200.tsp,steepest-ls,random-walk,N2,59,20350,19015,39365,4740,15.0
kroB200.tsp,qc-ls,random-walk,N2,124,19924,20415,40339,387,15.0
kroB200.tsp,greedy-cycle,random-walk,N2,85,17075,19852,36927,6,15.0
kroA200.tsp,qc-ls,random-walk,N2,43,24132,21509,45641,325,15.0
kroB200.tsp,candidate-ls,random-walk,N2,22,18987,19916,38903,1370,15.0
kroA200.tsp,steepest-ls,random-walk,N2,174,20187,20149,40336,4667,15.0
kroA200.tsp,qc-ls,random-walk,N2,158,23845,21164,45009,323,15.0
kroB200.tsp,candidate-ls,random-walk,N2,142,19556,20484,40040,1603,15.0
kroB200.tsp,qc-ls,random-walk,N2,61,19173,23055,42228,337,15.0
kroA200.tsp,steepest-ls,random-walk,N2,35,18084,18146,36230,5014,15.0
kroB200.tsp,candidate-ls,random-walk,N2,4,19304,20097,39401,1460,15.0
kroA200.tsp,greedy-cycle,random-walk,N2,184,17636,21615,39251,3,15.0
kroB200.tsp,candidate-ls,random-walk,N2,75,19432,19283,38715,1482,15.0
kroA200.tsp,queue-ls,random-walk,N2,118,22651,18832,41483,378,15.0
kroA200.tsp,qc-ls,random-walk,N2,14,21276,21126,42402,304,15.0
kroB200.tsp,greedy-cycle,random-walk,N2,162,17713,20396,38109,2,15.0
kroB200.tsp,steepest-ls,random-walk,N2,3,19227,19467,38694,4428,15.0
kroB200.tsp,steepest-ls,random-walk,N2,104,19434,20995,40429,4564,15.0
kroB200.tsp,qc-ls,random-walk,N2,36,21031,20752,41783,326,15.0
kroA200.tsp,steepest-ls,random-walk,N2,62,18599,18410,37009,4681,15.0
kroB200.tsp,queue-ls,random-walk,N2,176,20763,22464,43227,361,15.0
kroA200.tsp,candidate-ls,random-walk,N2,52,19259,18803,38062,1407,15.0
kroA200.tsp,queue-ls,random-walk,N2,94,22541,21314,43855,312,15.0
kroB200.tsp,greedy-cycle,random-walk,N2,174,20326,18102,38428,2,15.0
kroB200.tsp,steepest-ls,random-walk,N2,18,19226,18882,38108,4645,15.0
kroB200.tsp,candidate-ls,random-walk,N2,63,19486,19480,38966,1583,15.0
kroB200.tsp,queue-ls,random-walk,N2,160,20290,21126,41416,414,15.0
kroA200.tsp,steepest-ls,random-walk,N2,74,17760,19984,37744,4622,15.0
kroB200.tsp,qc-ls,random-walk,N2,20,23022,24606,47628,263,15.0
kroB200.tsp,steepest-ls,random-walk,N2,112,17992,20566,38558,4566,15.0
kroA200.tsp,queue-ls,random-walk,N2,82,19606,19447,39053,361,15.0
kroA200.tsp,candidate-ls,random-walk,N2,44,17993,20108,38101,1571,15.0
kroB200.tsp,candidate-ls,random-walk,N2,34,19160,20864,40024,1364,15.0
kroA200.tsp,qc-ls,random-walk,N2,55,22837,21653,44490,315,15.0
kroB200.tsp,greedy-cycle,random-walk,N2,93,17191,21859,39050,2,15.0
kroB200.tsp,qc-ls,random-walk,N2,132,24206,18920,43126,408,15.0
kroA200.tsp,steepest-ls,random-walk,N2,162,20400,18089,38489,4703,15.0
kroA200.tsp,greedy-cycle,random-walk,N2,192,17573,17750,35323,2,15.0
kroA200.tsp,steepest-ls,random-walk,N2,23,19516,20528,40044,4694,15.0
kroB200.tsp,qc-ls,random-walk,N2,77,20550,21304,41854,402,15.0
kroB200.tsp,candidate-ls,random-walk,N2,154,20780,18651,39431,1478,15.0
kroA200.tsp,candidate-ls,random-walk,N2,13,17731,19991,37722,1573,15.0
kroB200.tsp,qc-ls,random-walk,N2,98,20867,19947,40814,310,15.0
kroB200.tsp,steepest-ls,random-walk,N2,144,19890,21233,41123,4452,15.0
kroB200.tsp,qc-ls,random-walk,N2,76,21451,23830,45281,283,15.0
kroA200.tsp,steepest-ls,random-walk,N2,22,21152,20273,41425,4455,15.0
kroB200.tsp,queue-ls,random-walk,N2,136,19607,21907,41514,420,15.0
kroA200.tsp,candidate-ls,random-walk,N2,12,19670,18814,38484,1303,15.0
kroB200.tsp,qc-ls,random-walk,N2,99,22036,22097,44133,327,15.0
kroB200.tsp,candidate-ls,random-walk,N2,35,19818,19081,38899,1504,15.0
kroA200.tsp,queue-ls,random-walk,N2,158,29560,27638,57198,347,15.0
kroA200.tsp,qc-ls,random-walk,N2,54,20986,20561,41547,313,15.0
kroB200.tsp,greedy-cycle,random-walk,N2,92,20595,18141,38736,2,15.0
kroB200.tsp,greedy-cycle,random-walk,N2,122,18658,21333,39991,4,15.0
kroB200.tsp,candidate-ls,random-walk,N2,102,19197,20067,39264,1440,15.0
kroB200.tsp,qc-ls,random-walk,N2,21,21217,24105,45322,315,15.0
kroA200.tsp,steepest-ls,random-walk,N2,75,18484,19806,38290,4806,15.0
kroA200.tsp,queue-ls,random-walk,N2,83,27188,27980,55168,286,15.0
kroA200.tsp,candidate-ls,random-walk,N2,45,18523,19690,38213,1532,15.0
kroB200.tsp,steepest-ls,random-walk,N2,19,20599,18997,39596,4707,15.0
kroB200.tsp,qc-ls,random-walk,N2,164,21984,22818,44802,614,15.0
kroB200.tsp,candidate-ls,random-walk,N2,62,19504,19613,39117,1491,15.0
kroA200.tsp,steepest-ls,random-walk,N2,134,18536,19669,38205,4764,15.0
kroA200.tsp,qc-ls,random-walk,N2,118,20044,21319,41363,523,15.0
kroA200.tsp,steepest-ls,random-walk,N2,63,17975,19416,37391,4717,15.0
kroB200.tsp,qc-ls,random-walk,N2,37,22879,24145,47024,398,15.0
kroB200.tsp,candidate-ls,random-walk,N2,114,19047,19814,38861,1514,15.0
kroB200.tsp,queue-ls,random-walk,N2,198,20450,20527,40977,331,15.0
kroA200.tsp,candidate-ls,random-walk,N2,53,20976,17391,38367,1443,15.0
kroA200.tsp,queue-ls,random-walk,N2,95,20870,22460,43330,321,15.0
kroB200.tsp,candidate-ls,random-walk,N2,74,20084,19192,39276,1427,15.0
kroA200.tsp,qc-ls,random-walk,N2,15,22549,23979,46528,293,15.0
kroB200.tsp,qc-ls,random-walk,N2,172,21128,19392,40520,876,15.0
kroA200.tsp,steepest-ls,random-walk,N2,122,19163,19967,39130,4649,15.0
kroB200.tsp,steepest-ls,random-walk,N2,2,18797,19696,38493,4622,15.0
kroB200.tsp,queue-ls,random-walk,N2,120,23381,24910,48291,357,15.0
kroA200.tsp,steepest-ls,random-walk,N2,34,18482,19372,37854,4356,15.0
kroB200.tsp,qc-ls,random-walk,N2,60,19471,20904,40375,320,15.0
kroB200.tsp,candidate-ls,random-walk,N2,5,18778,19650,38428,1527,15.0
kroB200.tsp,steepest-ls,random-walk,N2,152,18371,19991,38362,4576,15.0
kroB200.tsp,greedy-cycle,random-walk,N2,134,18092,20396,38488,4,15.0
kroB200.tsp,qc-ls,random-walk,N2,1,18624,22988,41612,350,15.0
kroB200.tsp,steepest-ls,random-walk,N2,58,19140,18571,37711,4758,15.0
kroB200.tsp,greedy-cycle,random-walk,N2,84,19306,17792,37098,3,15.0
kroA200.tsp,qc-ls,random-walk,N2,42,22529,22665,45194,303,15.0
kroB200.tsp,candidate-ls,random-walk,N2,23,19667,19520,39187,1478,15.0
kroB200.tsp,queue-ls,random-walk,N2,99,22641,21739,44380,368,15.0
kroB200.tsp,candidate-ls,random-walk,N2,138,19655,18400,38055,1677,15.0
kroA200.tsp,greedy-cycle,random-walk,N2,37,16872,20167,37039,4,15.0
kroA200.tsp,candidate-ls,random-walk,N2,90,19086,18616,37702,1389,15.0
kroB200.tsp,queue-ls,random-walk,N2,76,21389,19431,40820,336,15.0
kroA200.tsp,queue-ls,random-walk,N2,56,19256,24126,43382,287,15.0
kroA200.tsp,candidate-ls,random-walk,N2,166,18180,19835,38015,1449,15.0
kroA200.tsp,queue-ls,random-walk,N2,7,21172,22929,44101,542,15.0
kroB200.tsp,greedy-cycle,random-walk,N2,10,20595,18141,38736,2,15.0
kroB200.tsp,steepest-ls,random-walk,N2,200,21415,18540,39955,4581,15.0
kroA200.tsp,qc-ls,random-walk,N2,122,20307,20568,40875,360,15.0
kroB200.tsp,steepest-ls,random-walk,N2,23,19173,20810,39983,4660,15.0
kroA200.tsp,qc-ls,random-walk,N2,39,21525,21307,42832,397,15.0
kroB200.tsp,candidate-ls,random-walk,N2,58,21980,19092,41072,1332,15.0
kroA200.tsp,qc-ls,random-walk,N2,4,22416,21462,43878,368,15.0
kroB200.tsp,candidate-ls,random-walk,N2,180,20338,18025,38363,1498,15.0
kroA200.tsp,candidate-ls,random-walk,N2,28,19817,18426,38243,1393,15.0
kroA200.tsp,greedy-cycle,random-walk,N2,146,18201,17472,35673,2,15.0
kroB200.tsp,queue-ls,random-walk,N2,21,20373,21935,42308,643,15.0
kroA200.tsp,steepest-ls,random-walk,N2,18,20279,18910,39189,4557,15.0
kroA200.tsp,greedy-cycle,random-walk,N2,60,18273,17472,35745,2,15.0
kroA200.tsp,qc-ls,random-walk,N2,81,23324,23699,47023,311,15.0
kroB200.tsp,greedy-cycle,random-walk,N2,47,21187,18065,39252,2,15.0
kroA200.tsp,queue-ls,random-walk,N2,162,20816,21080,41896,353,15.0
kroB200.tsp,steepest-ls,random-walk,N2,74,20926,18239,39165,4461,15.0
kroB200.tsp,greedy-cycle,random-walk,N2,118,17606,20396,38002,3,15.0
kroA200.tsp,greedy-cycle,random-walk,N2,150,16539,22671,39210,2,15.0
kroA200.tsp,greedy-cycle,random-walk,N2,99,20645,17365,38010,2,15.0
kroB200.tsp,candidate-ls,random-walk,N2,196,18628,21046,39674,1412,15.0
kroA200.tsp,greedy-cycle,random-walk,N2,76,17191,22196,39387,4,15.0
kroB200.tsp,queue-ls,random-walk,N2,37,19299,21703,41002,409,15.0
kroB200.tsp,queue-ls,random-walk,N2,6,21034,21009,42043,360,15.0
kroB200.tsp,steepest-ls,random-walk,N2,168,19703,18108,37811,4626,15.0
kroA200.tsp,queue-ls,random-walk,N2,17,22812,22224,45036,604,15.0
kroB200.tsp,greedy-cycle,random-walk,N2,51,22356,17475,39831,2,15.0
kroA200.tsp,qc-ls,random-walk,N2,97,20648,23981,44629,324,15.0
kroB200.tsp,steepest-ls,random-walk,N2,62,20718,20042,40760,4610,15.0
kroA200.tsp,qc-ls,random-walk,N2,78,19589,20193,39782,350,15.0
kroA200.tsp,queue-ls,random-walk,N2,174,21535,20903,42438,570,15.0
kroB200.tsp,candidate-ls,random-walk,N2,19,18445,18720,37165,1651,15.0
kroA200.tsp,candidate-ls,random-walk,N2,69,19718,21043,40761,1403,15.0
kroA200.tsp,queue-ls,random-walk,N2,40,23874,23034,46908,270,15.0
kroB200.tsp,queue-ls,random-walk,N2,60,21042,22537,43579,344,15.0
kroA200.tsp,steepest-ls,random-walk,N2,59,19217,18859,38076,5022,15.0
kroA200.tsp,candidate-ls,random-walk,N2,86,20912,18058,38970,1468,15.0
kroA200.tsp,greedy-cycle,random-walk,N2,21,16595,22671,39266,2,15.0
kroA200.tsp,qc-ls,random-walk,N2,134,19846,22450,42296,354,15.0
kroA200.tsp,steepest-ls,random-walk,N2,118,19385,18488,37873,4714,15.0
kroA200.tsp,candidate-ls,random-walk,N2,170,17108,19501,36609,1617,15.0
kroA200.tsp,candidate-ls,random-walk,N2,4,18597,20653,39250,1506,15.0
kroB200.tsp,qc-ls,random-walk,N2,148,21121,20242,41363,324,15.0
kroB200.tsp,steepest-ls,random-walk,N2,35,19381,19408,38789,4641,15.0
kroB200.tsp,steepest-ls,random-walk,N2,42,19318,17804,37122,5039,15.0
kroA200.tsp,steepest-ls,random-walk,N2,180,19134,19239,38373,4699,15.0
kroA200.tsp,qc-ls,random-walk,N2,58,20133,20915,41048,293,15.0
kroA200.tsp,queue-ls,random-walk,N2,154,27337,32516,59853,289,15.0
kroB200.tsp,candidate-ls,random-walk,N2,39,18910,19926,38836,1499,15.0
kroB200.tsp,greedy-cycle,random-walk,N2,71,17065,21551,38616,3,15.0
kroA200.tsp,greedy-cycle,random-walk,N2,56,20906,18253,39159,2,15.0
kroB200.tsp,queue-ls,random-walk,N2,17,20121,20206,40327,444,15.0
kroB200.tsp,steepest-ls,random-walk,N2,148,20000,17801,37801,4640,15.0
kroA200.tsp,queue-ls,random-walk,N2,37,20327,21072,41399,367,15.0
kroA200.tsp,greedy-cycle,random-walk,N2,170,17168,20167,37335,2,15.0
kroB200.tsp,greedy-cycle,random-walk,N2,6,17307,21859,39166,2,15.0
kroB200.tsp,qc-ls,random-walk,N2,95,21055,18966,40021,372,15.0
kroB200.tsp,qc-ls,random-walk,N2,168,25850,25440,51290,349,15.0
kroB200.tsp,steepest-ls,random-walk,N2,15,19932,20083,40015,4479,15.0
kroA200.tsp,qc-ls,random-walk,N2,114,22155,22476,44631,367,15.0
kroB200.tsp,greedy-cycle,random-walk,N2,196,18520,21333,39853,2,15.0
kroA200.tsp,steepest-ls,random-walk,N2,138,19591,18628,38219,5032,15.0
kroB200.tsp,greedy-cycle,random-walk,N2,26,18700,20519,39219,2,15.0
kroB200.tsp,candidate-ls,random-walk,N2,81,18059,21133,39192,1741,15.0
kroA200.tsp,candidate-ls,random-walk,N2,150,20604,18258,38862,1517,15.0
kroA200.tsp,queue-ls,random-walk,N2,60,22686,20581,43267,321,15.0
kroB200.tsp,queue-ls,random-walk,N2,40,20860,22071,42931,311,15.0
kroA200.tsp,steepest-ls,random-walk,N2,79,17967,18732,36699,4618,15.0
kroB200.tsp,queue-ls,random-walk,N2,182,21110,21103,42213,340,15.0
kroA200.tsp,candidate-ls,random-walk,N2,49,18288,20329,38617,1360,15.0
kroA200.tsp,steepest-ls,random-walk,N2,96,19583,18773,38356,4892,15.0
kroA200.tsp,qc-ls,random-walk,N2,19,21380,21293,42673,323,15.0
kroB200.tsp,candidate-ls,random-walk,N2,78,18744,20990,39734,1399,15.0
kroA200.tsp,candidate-ls,random-walk,N2,146,20003,19982,39985,1513,15.0
kroB200.tsp,candidate-ls,random-walk,N2,97,17441,19260,36701,1567,15.0
kroB200.tsp,greedy-cycle,random-walk,N2,30,21184,18065,39249,2,15.0
kroB200.tsp,greedy-cycle,random-walk,N2,180,17206,20759,37965,2,15.0
kroA200.tsp,qc-ls,random-walk,N2,102,22214,24208,46422,259,15.0
kroB200.tsp,candidate-ls,random-walk,N2,118,19566,19948,39514,1555,15.0
kroA200.tsp,greedy-cycle,random-walk,N2,17,18068,17472,35540,2,15.0
kroB200.tsp,queue-ls,random-walk,N2,56,19920,22766,42686,340,15.0
kroA200.tsp,queue-ls,random-walk,N2,76,26046,26361,52407,261,15.0
kroA200.tsp,queue-ls,random-walk,N2,99,28540,31464,60004,279,15.0
kroA200.tsp,steepest-ls,random-walk,N2,80,17662,21383,39045,4470,15.0
kroB200.tsp,queue-ls,random-walk,N2,194,21048,19001,40049,415,15.0
kroA200.tsp,queue-ls,random-walk,N2,142,20122,21066,41188,369,15.0
kroB200.tsp,greedy-cycle,random-walk,N2,88,17798,20510,38308,5,15.0
kroA200.tsp,steepest-ls,random-walk,N2,196,18828,17818,36646,4584,15.0
kroB200.tsp,steepest-ls,random-walk,N2,54,18310,19701,38011,4827,15.0
kroB200.tsp,greedy-cycle,random-walk,N2,138,18500,20807,39307,3,15.0
kroB200.tsp,greedy-cycle,random-walk,N2,67,18658,21333,39991,2,15.0
kroA200.tsp,queue-ls,random-walk,N2,21,17748,23467,41215,431,15.0
kroB200.tsp,candidate-ls,random-walk,N2,9,18644,19356,38000,1580,15.0
kroA200.tsp,steepest-ls,random-walk,N2,38,19903,19585,39488,4431,15.0
kroA200.tsp,greedy-cycle,random-walk,N2,40,19236,21988,41224,6,15.0
kroB200.tsp,qc-ls,random-walk,N2,83,19945,20510,40455,347,15.0
kroB200.tsp,qc-ls,random-walk,N2,200,21267,21964,43231,335,15.0
kroA200.tsp,greedy-cycle,random-walk,N2,166,18122,21693,39815,2,15.0
kroA200.tsp,greedy-cycle,random-walk,N2,7,16595,22671,39266,2,15.0
kroA200.tsp,steepest-ls,random-walk,N2,7,18568,18988,37556,4894,15.0
kroA200.tsp,steepest-ls,random-walk,N2,102,18809,19263,38072,4458,15.0
kroB200.tsp,candidate-ls,random-walk,N2,54,18695,21334,40029,1315,15.0
kroA200.tsp,qc-ls,random-walk,N2,35,22101,20650,42751,355,15.0
kroB200.tsp,qc-ls,random-walk,N2,152,22994,22665,45659,319,15.0
kroA200.tsp,candidate-ls,random-walk,N2,73,19577,19847,39424,1576,15.0
kroB200.tsp,queue-ls,random-walk,N2,95,19701,20823,40524,378,15.0
kroA200.tsp,steepest-ls,random-walk,N2,43,18661,20460,39121,4584,15.0
kroB200.tsp,qc-ls,random-walk,N2,17,19188,22437,41625,360,15.0
kroB200.tsp,candidate-ls,random-walk,N2,134,20211,18201,38412,1621,15.0
kroB200.tsp,steepest-ls,random-walk,N2,97,19207,17926,37133,4928,15.0
kroB200.tsp,greedy-cycle,random-walk,N2,114,18160,20656,38816,6,15.0
kroA200.tsp,qc-ls,random-walk,N2,196,20942,20151,41093,395,15.0
kroB200.tsp,steepest-ls,random-walk,N2,78,19283,19297,38580,4550,15.0
kroA200.tsp,qc-ls,random-walk,N2,62,19450,22070,41520,333,15.0
kroA200.tsp,candidate-ls,random-walk,N2,24,18336,19605,37941,1492,15.0
kroA200.tsp,greedy-cycle,random-walk,N2,83,21163,17365,38528,2,15.0
kroA200.tsp,qc-ls,random-walk,N2,8,19833,21255,41088,335,15.0
kroB200.tsp,queue-ls,random-walk,N2,100,21529,20306,41835,319,15.0
kroA200.tsp,steepest-ls,random-walk,N2,14,18276,20629,38905,4706,15.0
kroB200.tsp,qc-ls,random-walk,N2,40,19685,20419,40104,349,15.0
kroB200.tsp,steepest-ls,random-walk,N2,172,18953,20133,39086,4496,15.0
kroB200.tsp,steepest-ls,random-walk,N2,81,19444,19104,38548,4740,15.0
kroB200.tsp,candidate-ls,random-walk,N2,15,19787,20080,39867,1567,15.0
kroA200.tsp,queue-ls,random-walk,N2,178,20707,18610,39317,356,15.0
kroA200.tsp,qc-ls,random-walk,N2,74,20555,19718,40273,316,15.0
kroA200.tsp,qc-ls,random-walk,N2,180,29282,25178,54460,294,15.0
kroB200.tsp,greedy-cycle,random-walk,N2,102,18638,20487,39125,3,15.0
kroA200.tsp,greedy-cycle,random-walk,N2,95,21218,17365,38583,2,15.0
kroA200.tsp,candidate-ls,random-walk,N2,32,18831,19991,38822,1500,15.0
kroB200.tsp,steepest-ls,random-walk,N2,164,19444,19248,38692,4940,15.0
kroB200.tsp,qc-ls,random-walk,N2,56,21982,19422,41404,311,15.0
kroB200.tsp,queue-ls,random-walk,N2,116,20276,20345,40621,688,15.0
kroA200.tsp,steepest-ls,random-walk,N2,114,19397,18974,38371,4737,15.0
kroA200.tsp,qc-ls,random-walk,N2,138,26313,25459,51772,303,15.0
kroB200.tsp,steepest-ls,random-walk,N2,39,18679,20469,39148,4675,15.0
kroB200.tsp,qc-ls,random-walk,N2,144,20419,21750,42169,309,15.0
kroA200.tsp,candidate-ls,random-walk,N2,8,20635,18080,38715,1377,15.0
kroA200.tsp,qc-ls,random-walk,N2,23,22450,20418,42868,329,15.0
kroB200.tsp,candidate-ls,random-walk,N2,42,20164,19393,39557,1374,15.0
kroB200.tsp,queue-ls,random-walk,N2,83,21087,20875,41962,375,15.0
kroA200.tsp,candidate-ls,random-walk,N2,65,21296,19291,40587,1629,15.0
kroB200.tsp,candidate-ls,random-walk,N2,122,20304,19544,39848,1473,15.0
kroA200.tsp,steepest-ls,random-walk,N2,55,19449,18984,38433,5170,15.0
kroB200.tsp,candidate-ls,random-walk,N2,200,18594,19153,37747,1543,15.0
kroB200.tsp,steepest-ls,random-walk,N2,32,19194,19199,38393,4387,15.0
kroA200.tsp,candidate-ls,random-walk,N2,3,18894,18480,37374,1565,15.0
kroA200.tsp,candidate-ls,random-walk,N2,198,19608,18221,37829,1513,15.0
kroA200.tsp,queue-ls,random-walk,N2,124,22458,21042,43500,426,15.0
kroB200.tsp,candidate-ls,random-walk,N2,49,18488,20844,39332,1683,15.0
kroA200.tsp,qc-ls,random-walk,N2,28,21826,18184,40010,322,15.0
kroB200.tsp,queue-ls,random-walk,N2,88,20247,20980,41227,305,15.0
kroA200.tsp,greedy-cycle,random-walk,N2,100,20757,17365,38122,3,15.0
kroA200.tsp,candidate-ls,random-walk,N2,81,19814,21106,40920,1577,15.0
kroA200.tsp,greedy-cycle,random-walk,N2,26,18444,18709,37153,2,15.0
kroA200.tsp,queue-ls,random-walk,N2,47,21313,18734,40047,420,15.0
kroB200.tsp,steepest-ls,random-walk,N2,138,19231,19113,38344,4502,15.0
kroB200.tsp,queue-ls,random-walk,N2,67,20502,20225,40727,419,15.0
kroA200.tsp,steepest-ls,random-walk,N2,148,19468,18641,38109,4450,15.0
kroA200.tsp,qc-ls,random-walk,N2,164,22404,21147,43551,317,15.0
kroA200.tsp,candidate-ls,random-walk,N2,120,17781,19526,37307,1812,15.0
kroA200.tsp,qc-ls,random-walk,N2,90,19471,19836,39307,367,15.0
kroB200.tsp,greedy-cycle,random-walk,N2,56,17191,21859,39050,5,15.0
kroB200.tsp,qc-ls,random-walk,N2,118,18375,20192,38567,570,15.0
kroB200.tsp,steepest-ls,random-walk,N2,65,18680,19166,37846,4895,15.0
kroA200.tsp,candidate-ls,random-walk,N2,39,18989,18061,37050,1509,15.0
kroB200.tsp,steepest-ls,random-walk,N2,180,19565,21080,40645,4711,15.0
kroB200.tsp,queue-ls,random-walk,N2,1,24235,25675,49910,276,15.0
kroB200.tsp,queue-ls,random-walk,N2,30,21446,23000,44446,297,15.0
kroA200.tsp,queue-ls,random-walk,N2,10,22960,19748,42708,362,15.0
kroA200.tsp,greedy-cycle,random-walk,N2,71,16872,20167,37039,3,15.0
kroB200.tsp,greedy-cycle,random-walk,N2,40,18987,16849,35836,3,15.0
kroA200.tsp,qc-ls,random-walk,N2,86,20066,20821,40887,354,15.0
kroA200.tsp,candidate-ls,random-walk,N2,136,19776,19472,39248,1652,15.0
kroA200.tsp,qc-ls,random-walk,N2,172,20732,18847,39579,348,15.0
kroB200.tsp,steepest-ls,random-walk,N2,73,18951,20307,39258,4625,15.0
kroA200.tsp,qc-ls,random-walk,N2,69,18718,22572,41290,343,15.0
kroB200.tsp,steepest-ls,random-walk,N2,196,17757,19111,36868,5056,15.0
kroA200.tsp,greedy-cycle,random-walk,N2,88,19236,21988,41224,2,15.0
kroA200.tsp,qc-ls,random-walk,N2,3,24718,21953,46671,303,15.0
kroB200.tsp,candidate-ls,random-walk,N2,168,19848,19182,39030,1463,15.0
kroA200.tsp,greedy-cycle,random-walk,N2,67,18327,19625,37952,2,15.0
kroB200.tsp,queue-ls,random-walk,N2,26,21909,21089,42998,322,15.0
kroB200.tsp,greedy-cycle,random-walk,N2,17,17976,20396,38372,2,15.0
kroA200.tsp,queue-ls,random-walk,N2,132,21455,23234,44689,316,15.0
kroB200.tsp,greedy-cycle,random-walk,N2,148,18256,21333,39589,2,15.0
kroB200.tsp,steepest-ls,random-walk,N2,24,20420,19986,40406,4975,15.0
kroA200.tsp,candidate-ls,random-walk,N2,78,20384,17720,38104,1309,15.0
kroA200.tsp,greedy-cycle,random-walk,N2,116,17362,18993,36355,3,15.0
kroB200.tsp,queue-ls,random-walk,N2,71,23060,25878,48938,338,15.0
kroA200.tsp,steepest-ls,random-walk,N2,48,18324,19426,37750,4635,15.0
kroA200.tsp,queue-ls,random-walk,N2,51,23937,20554,44491,338,15.0
kroA200.tsp,greedy-cycle,random-walk,N2,30,16527,21633,38160,2,15.0
kroA200.tsp,candidate-ls,random-walk,N2,97,18790,18703,37493,1486,15.0
kroA200.tsp,qc-ls,random-walk,N2,45,21659,22795,44454,310,15.0
kroB200.tsp,greedy-cycle,random-walk,N2,83,17191,21859,39050,2,15.0
kroB200.tsp,candidate-ls,random-walk,N2,24,20575,20221,40796,1374,15.0
kroB200.tsp,qc-ls,random-walk,N2,122,18653,20399,39052,409,15.0
kroB200.tsp,qc-ls,random-walk,N2,6,18341,23211,41552,316,15.0
kroA200.tsp,steepest-ls,random-walk,N2,172,20699,18402,39101,4629,15.0
kroB200.tsp,candidate-ls,random-walk,N2,2,19275,19842,39117,1754,15.0
kroB200.tsp,qc-ls,random-walk,N2,67,20570,19663,40233,371,15.0
kroA200.tsp,steepest-ls,random-walk,N2,33,20022,19299,39321,4863,15.0
kroA200.tsp,greedy-cycle,random-walk,N2,182,16583,22671,39254,2,15.0
kroB200.tsp,candidate-ls,random-walk,N2,144,20444,20640,41084,1423,15.0
kroB200.tsp,qc-ls,random-walk,N2,88,21396,22217,43613,273,15.0
kroB200.tsp,greedy-cycle,random-walk,N2,164,17789,20510,38299,2,15.0
kroB200.tsp,candidate-ls,random-walk,N2,73,21538,19376,40914,1606,15.0
kroA200.tsp,qc-ls,random-walk,N2,12,20168,20027,40195,350,15.0
kroB200.tsp,steepest-ls,random-walk,N2,5,19791,19127,38918,4751,15.0
kroB200.tsp,queue-ls,random-walk,N2,170,23848,22536,46384,380,15.0
kroB200.tsp,steepest-ls,random-walk,N2,102,18991,20078,39069,4267,15.0
kroB200.tsp,qc-ls,random-walk,N2,30,21215,21964,43179,291,15.0
kroA200.tsp,steepest-ls,random-walk,N2,64,18071,18952,37023,4847,15.0
kroA200.tsp,queue-ls,random-walk,N2,92,22934,22304,45238,309,15.0
kroA200.tsp,candidate-ls,random-walk,N2,54,18727,19380,38107,1413,15.0
kroB200.tsp,candidate-ls,random-walk,N2,65,19900,19782,39682,1665,15.0
kroA200.tsp,queue-ls,random-walk,N2,108,21889,21521,43410,395,15.0
kroB200.tsp,greedy-cycle,random-walk,N2,172,18878,19742,38620,2,15.0
kroA200.tsp,steepest-ls,random-walk,N2,72,19254,20485,39739,4424,15.0
kroB200.tsp,qc-ls,random-walk,N2,26,19580,20453,40033,349,15.0
kroB200.tsp,steepest-ls,random-walk,N2,114,19766,20451,40217,4492,15.0
kroB200.tsp,queue-ls,random-walk,N2,166,26480,22480,48960,301,15.0
kroA200.tsp,candidate-ls,random-walk,N2,42,19971,20123,40094,1274,15.0
kroA200.tsp,queue-ls,random-walk,N2,84,24034,22074,46108,292,15.0
kroB200.tsp,steepest-ls,random-walk,N2,49,18642,19527,38169,4823,15.0
kroB200.tsp,qc-ls,random-walk,N2,134,20239,24437,44676,339,15.0
kroB200.tsp,candidate-ls,random-walk,N2,32,19216,18954,38170,1480,15.0
kroB200.tsp,greedy-cycle,random-walk,N2,95,17685,20396,38081,2,15.0
kroA200.tsp,qc-ls,random-walk,N2,53,21653,19648,41301,346,15.0
kroA200.tsp,qc-ls,random-walk,N2,148,24188,20156,44344,305,15.0
kroA200.tsp,steepest-ls,random-walk,N2,164,19683,19389,39072,4485,15.0
kroB200.tsp,candidate-ls,random-walk,N2,152,20147,19086,39233,1545,15.0
kroA200.tsp,greedy-cycle,random-walk,N2,194,17402,18062,35464,3,15.0
kroA200.tsp,steepest-ls,random-walk,N2,25,19469,18980,38449,4720,15.0
kroB200.tsp,qc-ls,random-walk,N2,71,19375,19964,39339,376,15.0
kroA200.tsp,candidate-ls,random-walk,N2,15,18476,19779,38255,1518,15.0
kroA200.tsp,candidate-ls,random-walk,N2,62,19084,19234,38318,1412,15.0
kroB200.tsp,queue-ls,random-walk,N2,84,19770,20787,40557,338,15.0
kroA200.tsp,steepest-ls,random-walk,N2,52,19868,21326,41194,4501,15.0
kroB200.tsp,steepest-ls,random-walk,N2,134,19620,18894,38514,4972,15.0
kroB200.tsp,queue-ls,random-walk,N2,146,26780,24288,51068,264,15.0
kroA200.tsp,qc-ls,random-walk,N2,24,20863,19390,40253,320,15.0
kroB200.tsp,candidate-ls,random-walk,N2,45,20531,19997,40528,1421,15.0
kroA200.tsp,queue-ls,random-walk,N2,128,21821,18704,40525,374,15.0
kroA200.tsp,candidate-ls,random-walk,N2,194,18889,19467,38356,1561,15.0
kroB200.tsp,greedy-cycle,random-walk,N2,152,17976,20396,38372,4,15.0
kroA200.tsp,greedy-cycle,random-walk,N2,92,18206,17472,35678,3,15.0
kroA200.tsp,candidate-ls,random-walk,N2,35,20072,19119,39191,1507,15.0
kroB200.tsp,candidate-ls,random-walk,N2,172,19732,18022,37754,1749,15.0
kroB200.tsp,qc-ls,random-walk,N2,51,24084,21130,45214,309,15.0
kroA200.tsp,queue-ls,random-walk,N2,190,21013,20989,42002,398,15.0
kroA200.tsp,qc-ls,random-walk,N2,168,20873,19633,40506,427,15.0
kroB200.tsp,steepest-ls,random-walk,N2,86,19014,20724,39738,4749,15.0
kroA200.tsp,steepest-ls,random-walk,N2,144,19180,18277,37457,4884,15.0
kroB200.tsp,steepest-ls,random-walk,N2,69,19547,19796,39343,4684,15.0
kroB200.tsp,qc-ls,random-walk,N2,114,24347,25454,49801,396,15.0
kroB200.tsp,candidate-ls,random-walk,N2,12,19004,19946,38950,1390,15.0
kroA200.tsp,qc-ls,random-walk,N2,73,26470,21084,47554,301,15.0
kroA200.tsp,candidate-ls,random-walk,N2,23,19062,19432,38494,1565,15.0
kroA200.tsp,greedy-cycle,random-walk,N2,84,18444,18709,37153,2,15.0
kroB200.tsp,qc-ls,random-walk,N2,47,20735,21478,42213,398,15.0
kroA200.tsp,steepest-ls,random-walk,N2,13,20157,18871,39028,4816,15.0
kroB200.tsp,candidate-ls,random-walk,N2,164,19035,19259,38294,1405,15.0
kroA200.tsp,steepest-ls,random-walk,N2,152,19106,19813,38919,4850,15.0
kroB200.tsp,steepest-ls,random-walk,N2,90,19603,19488,39091,4305,15.0
kroA200.tsp,queue-ls,random-walk,N2,186,24104,24392,48496,350,15.0
kroA200.tsp,qc-ls,random-walk,N2,65,21700,19108,40808,341,15.0
kroB200.tsp,qc-ls,random-walk,N2,102,20321,20478,40799,358,15.0
kroB200.tsp,queue-ls,random-walk,N2,92,24087,22498,46585,306,15.0
kroA200.tsp,candidate-ls,random-walk,N2,74,19036,20549,39585,1452,15.0
kroB200.tsp,queue-ls,random-walk,N2,150,23367,25625,48992,407,15.0
kroB200.tsp,steepest-ls,random-walk,N2,122,20080,19105,39185,4662,15.0
kroA200.tsp,qc-ls,random-walk,N2,200,23917,24618,48535,323,15.0
kroB200.tsp,qc-ls,random-walk,N2,10,19197,20429,39626,355,15.0
kroA200.tsp,steepest-ls,random-walk,N2,44,18366,19678,38044,4596,15.0
kroB200.tsp,steepest-ls,random-walk,N2,28,19297,18493,37790,4580,15.0
kroB200.tsp,greedy-cycle,random-walk,N2,144,17789,20510,38299,2,15.0
kroA200.tsp,candidate-ls,random-walk,N2,182,18716,21248,39964,1475,15.0
kroB200.tsp,candidate-ls,random-walk,N2,53,19836,18779,38615,1613,15.0
kroA200.tsp,qc-ls,random-walk,N2,32,19658,21368,41026,328,15.0
kroB200.tsp,candidate-ls,random-walk,N2,148,20424,18744,39168,1540,15.0
kroA200.tsp,greedy-cycle,random-walk,N2,47,21179,17365,38544,3,15.0
kroA200.tsp,queue-ls,random-walk,N2,26,24490,22022,46512,281,15.0
kroB200.tsp,qc-ls,random-walk,N2,84,20408,20547,40955,338,15.0
kroB200.tsp,steepest-ls,random-walk,N2,53,18590,18903,37493,4554,15.0
kroB200.tsp,candidate-ls,random-walk,N2,28,18912,20133,39045,1317,15.0
kroA200.tsp,qc-ls,random-walk,N2,49,19948,20430,40378,346,15.0
kroB200.tsp,greedy-cycle,random-walk,N2,60,18725,20274,38999,6,15.0
kroA200.tsp,candidate-ls,random-walk,N2,116,18973,19892,38865,1575,15.0
kroA200.tsp,qc-ls,random-walk,N2,152,19778,20811,40589,433,15.0
kroB200.tsp,queue-ls,random-walk,N2,51,19980,21725,41705,419,15.0
kroA200.tsp,steepest-ls,random-walk,N2,68,20548,18100,38648,4625,15.0
kroA200.tsp,steepest-ls,random-walk,N2,200,20784,18639,39423,4455,15.0
kroA200.tsp,queue-ls,random-walk,N2,71,20274,20111,40385,380,15.0
kroA200.tsp,greedy-cycle,random-walk,N2,10,21163,17365,38528,7,15.0
kroA200.tsp,candidate-ls,random-walk,N2,58,19593,20105,39698,1397,15.0
kroA200.tsp,greedy-cycle,random-walk,N2,136,18193,21615,39808,7,15.0
kroA200.tsp,steepest-ls,random-walk,N2,87,19543,21488,41031,4639,15.0
kroA200.tsp,queue-ls,random-walk,N2,112,28814,32527,61341,340,15.0
kroB200.tsp,greedy-cycle,random-walk,N2,168,17191,20902,38093,2,15.0
kroB200.tsp,qc-ls,random-walk,N2,196,20420,21414,41834,388,15.0
kroB200.tsp,candidate-ls,random-walk,N2,90,18938,19958,38896,1383,15.0
kroB200.tsp,steepest-ls,random-walk,N2,9,19410,18847,38257,4683,15.0
kroB200.tsp,greedy-cycle,random-walk,N2,37,17024,19852,36876,5,15.0
kroA200.tsp,queue-ls,random-walk,N2,67,22608,25101,47709,312,15.0
kroB200.tsp,steepest-ls,random-walk,N2,118,20240,18943,39183,4815,15.0
kroB200.tsp,queue-ls,random-walk,N2,47,19885,18435,38320,401,15.0
kroA200.tsp,steepest-ls,random-walk,N2,91,20611,18635,39246,4664,15.0
kroA200.tsp,greedy-cycle,random-walk,N2,120,17924,17472,35396,6,15.0
kroA200.tsp,queue-ls,random-walk,N2,88,18967,20505,39472,342,15.0
kroB200.tsp,steepest-ls,random-walk,N2,12,18941,19468,38409,4533,15.0
kroA200.tsp,queue-ls,random-walk,N2,104,21924,23328,45252,301,15.0
kroB200.tsp,candidate-ls,random-walk,N2,69,19620,18718,38338,1640,15.0
kroB200.tsp,greedy-cycle,random-walk,N2,21,17701,20396,38097,2,15.0
kroB200.tsp,candidate-ls,random-walk,N2,86,18512,19339,37851,1470,15.0
kroB200.tsp,qc-ls,random-walk,N2,180,21917,19977,41894,530,15.0
kroB200.tsp,queue-ls,random-walk,N2,10,20567,18205,38772,370,15.0
kroA200.tsp,steepest-ls,random-walk,N2,29,19814,19840,39654,4676,15.0
kroA200.tsp,queue-ls,random-walk,N2,30,21354,20221,41575,337,15.0
kroA200.tsp,greedy-cycle,random-walk,N2,198,18273,17472,35745,3,15.0
kroA200.tsp,greedy-cycle,random-walk,N2,51,21265,17365,38630,2,15.0
kroA200.tsp,candidate-ls,random-walk,N2,19,19681,17265,36946,1494,15.0
kroB200.tsp,greedy-cycle,random-walk,N2,1,21032,18065,39097,2,15.0
kroB200.tsp,greedy-cycle,random-walk,N2,200,18745,21184,39929,4,15.0
kroB200.tsp,qc-ls,random-walk,N2,92,19083,21285,40368,324,15.0
kroB200.tsp,greedy-cycle,random-walk,N2,99,18449,21333,39782,2,15.0
kroB200.tsp,qc-ls,random-walk,N2,138,25184,19513,44697,544,15.0
kroB200.tsp,steepest-ls,random-walk,N2,45,18948,19185,38133,4592,15.0
kroA200.tsp,steepest-ls,random-walk,N2,168,18981,17922,36903,4966,15.0
kroA200.tsp,qc-ls,random-walk,N2,144,19682,19632,39314,417,15.0
kroA200.tsp,candidate-ls,random-walk,N2,100,19483,17838,37321,1518,15.0
kroB200.tsp,greedy-cycle,random-walk,N2,76,17910,20396,38306,3,15.0
kroB200.tsp,greedy-cycle,random-walk,N2,98,20595,18141,38736,2,15.0
kroA200.tsp,queue-ls,random-walk,N2,152,21983,17176,39159,423,15.0
kroB200.tsp,greedy-cycle,random-walk,N2,128,20595,18141,38736,3,15.0
kroB200.tsp,steepest-ls,random-walk,N2,44,19529,18133,37662,5152,15.0
kroA200.tsp,steepest-ls,random-walk,N2,186,19637,18995,38632,4550,15.0
kroB200.tsp,greedy-cycle,random-walk,N2,77,18562,16849,35411,2,15.0
kroB200.tsp,queue-ls,random-walk,N2,11,20358,19984,40342,415,15.0
kroA200.tsp,steepest-ls,random-walk,N2,28,20192,19516,39708,4745,15.0
kroA200.tsp,queue-ls,random-walk,N2,31,19835,19911,39746,407,15.0
kroA200.tsp,greedy-cycle,random-walk,N2,50,21589,18253,39842,2,15.0
kroA200.tsp,candidate-ls,random-walk,N2,18,20149,19041,39190,1372,15.0
kroA200.tsp,greedy-cycle,random-walk,N2,176,16626,21633,38259,2,15.0
kroB200.tsp,qc-ls,random-walk,N2,93,20853,18600,39453,361,15.0
kroB200.tsp,steepest-ls,random-walk,N2,13,19855,18319,38174,5001,15.0
kroB200.tsp,candidate-ls,random-walk,N2,68,21218,18767,39985,1342,15.0
kroB200.tsp,greedy-cycle,random-walk,N2,20,16866,22271,39137,4,15.0
kroA200.tsp,candidate-ls,random-walk,N2,156,21849,17583,39432,1409,15.0
kroB200.tsp,candidate-ls,random-walk,N2,87,20315,19866,40181,1576,15.0
kroA200.tsp,qc-ls,random-walk,N2,112,23321,19901,43222,334,15.0
kroB200.tsp,greedy-cycle,random-walk,N2,190,17713,20396,38109,2,15.0
kroB200.tsp,candidate-ls,random-walk,N2,108,20656,19037,39693,1713,15.0
kroA200.tsp,queue-ls,random-walk,N2,66,20617,19216,39833,339,15.0
kroB200.tsp,queue-ls,random-walk,N2,46,23546,26455,50001,248,15.0
kroA200.tsp,steepest-ls,random-walk,N2,90,18719,19744,38463,4613,15.0
kroA200.tsp,queue-ls,random-walk,N2,89,24401,24947,49348,302,15.0
kroB200.tsp,queue-ls,random-walk,N2,184,22366,24983,47349,311,15.0
kroB200.tsp,qc-ls,random-walk,N2,178,27061,25177,52238,282,15.0
kroA200.tsp,steepest-ls,random-walk,N2,128,19435,18460,37895,4914,15.0
kroB200.tsp,greedy-cycle,random-walk,N2,186,21562,18065,39627,2,15.0
kroA200.tsp,qc-ls,random-walk,N2,104,25978,25399,51377,249,15.0
kroB200.tsp,candidate-ls,random-walk,N2,91,19028,19446,38474,1720,15.0
kroB200.tsp,steepest-ls,random-walk,N2,8,18847,19679,38526,4580,15.0
kroA200.tsp,candidate-ls,random-walk,N2,140,17784,20279,38063,1581,15.0
kroB200.tsp,greedy-cycle,random-walk,N2,36,18249,20790,39039,4,15.0
kroB200.tsp,queue-ls,random-walk,N2,50,18657,20617,39274,347,15.0
kroA200.tsp,steepest-ls,random-walk,N2,69,19153,20651,39804,4950,15.0
kroA200.tsp,queue-ls,random-walk,N2,70,24558,24972,49530,254,15.0
kroA200.tsp,greedy-cycle,random-walk,N2,11,18201,17472,35673,4,15.0
kroA200.tsp,candidate-ls,random-walk,N2,59,19490,20568,40058,1432,15.0
kroB200.tsp,queue-ls,random-walk,N2,192,21848,22275,44123,344,15.0
kroA200.tsp,steepest-ls,random-walk,N2,86,19295,19228,38523,4348,15.0
kroA200.tsp,steepest-ls,random-walk,N2,190,19912,20090,40002,4401,15.0
kroB200.tsp,steepest-ls,random-walk,N2,52,18772,19663,38435,4711,15.0
kroA200.tsp,queue-ls,random-walk,N2,144,17929,23586,41515,448,15.0
kroB200.tsp,candidate-ls,random-walk,N2,29,18500,18833,37333,1654,15.0
kroA200.tsp,qc-ls,random-walk,N2,48,19106,19693,38799,343,15.0
kroB200.tsp,greedy-cycle,random-walk,N2,61,17127,20759,37886,2,15.0
kroA200.tsp,greedy-cycle,random-walk,N2,46,16527,21633,38160,7,15.0
kroA200.tsp,queue-ls,random-walk,N2,27,18051,21939,39990,382,15.0
kroB200.tsp,steepest-ls,random-walk,N2,158,20907,17576,38483,4859,15.0
kroB200.tsp,qc-ls,random-walk,N2,85,20108,20284,40392,375,15.0
kroA200.tsp,greedy-cycle,random-walk,N2,160,17683,22307,39990,2,15.0
kroA200.tsp,qc-ls,random-walk,N2,128,21279,17873,39152,409,15.0
kroA200.tsp,steepest-ls,random-walk,N2,1,19869,19082,38951,4883,15.0
kroA200.tsp,greedy-cycle,random-walk,N2,1,18327,19625,37952,2,15.0
kroA200.tsp,steepest-ls,random-walk,N2,104,19720,21200,40920,4577,15.0
kroB200.tsp,steepest-ls,random-walk,N2,29,19037,18842,37879,4745,15.0
kroB200.tsp,qc-ls,random-walk,N2,154,22229,22679,44908,374,15.0
kroB200.tsp,candidate-ls,random-walk,N2,52,19769,20539,40308,1390,15.0
kroA200.tsp,qc-ls,random-walk,N2,33,20153,21543,41696,351,15.0
kroB200.tsp,queue-ls,random-walk,N2,93,21750,26482,48232,324,15.0
kroA200.tsp,candidate-ls,random-walk,N2,75,18324,19515,37839,1668,15.0
kroB200.tsp,candidate-ls,random-walk,N2,132,19737,19132,38869,1386,15.0
kroA200.tsp,steepest-ls,random-walk,N2,45,19222,20888,40110,4487,15.0
kroB200.tsp,qc-ls,random-walk,N2,11,19882,20784,40666,384,15.0
kroB200.tsp,steepest-ls,random-walk,N2,91,17280,19385,36665,4968,15.0
kroA200.tsp,qc-ls,random-walk,N2,64,21832,21578,43410,293,15.0
kroA200.tsp,queue-ls,random-walk,N2,168,20774,23205,43979,338,15.0
kroB200.tsp,greedy-cycle,random-walk,N2,112,18164,20656,38820,3,15.0
kroA200.tsp,qc-ls,random-walk,N2,190,20563,18862,39425,373,15.0
kroA200.tsp,candidate-ls,random-walk,N2,22,21551,18095,39646,1363,15.0
kroA200.tsp,greedy-cycle,random-walk,N2,85,17534,21403,38937,2,15.0
kroA200.tsp,steepest-ls,random-walk,N2,12,17828,20369,38197,4530,15.0
kroB200.tsp,qc-ls,random-walk,N2,46,21765,22855,44620,299,15.0
kroB200.tsp,steepest-ls,random-walk,N2,174,18206,19970,38176,4474,15.0
kroB200.tsp,queue-ls,random-walk,N2,106,21691,20009,41700,388,15.0
kroB200.tsp,steepest-ls,random-walk,N2,87,21444,19709,41153,4426,15.0
kroB200.tsp,steepest-ls,random-walk,N2,68,19540,20295,39835,6307,15.0
kroA200.tsp,qc-ls,random-walk,N2,186,21047,20637,41684,328,15.0
kroB200.tsp,greedy-cycle,random-walk,N2,104,17976,20396,38372,3,15.0
kroB200.tsp,candidate-ls,random-walk,N2,13,19836,19840,39676,1553,15.0
kroA200.tsp,qc-ls,random-walk,N2,72,25081,23196,48277,266,15.0
kroA200.tsp,greedy-cycle,random-walk,N2,93,17888,22204,40092,2,15.0
kroA200.tsp,candidate-ls,random-walk,N2,34,19376,19633,39009,1315,15.0
kroB200.tsp,queue-ls,random-walk,N2,110,22668,17830,40498,375,15.0
kroB200.tsp,steepest-ls,random-walk,N2,162,19176,18989,38165,4594,15.0
kroB200.tsp,qc-ls,random-walk,N2,50,20215,21082,41297,306,15.0
kroA200.tsp,steepest-ls,random-walk,N2,112,20052,18332,38384,4943,15.0
kroA200.tsp,qc-ls,random-walk,N2,25,21683,23391,45074,331,15.0
kroB200.tsp,candidate-ls,random-walk,N2,44,18876,18753,37629,1372,15.0
kroB200.tsp,qc-ls,random-walk,N2,142,20620,20742,41362,464,15.0
kroA200.tsp,candidate-ls,random-walk,N2,63,17954,18618,36572,1472,15.0
kroA200.tsp,queue-ls,random-walk,N2,200,19312,21507,40819,373,15.0
kroB200.tsp,queue-ls,random-walk,N2,85,25604,28657,54261,535,15.0
kroA200.tsp,steepest-ls,random-walk,N2,53,20220,19096,39316,5017,15.0
kroB200.tsp,candidate-ls,random-walk,N2,124,18534,19574,38108,1511,15.0
kroB200.tsp,queue-ls,random-walk,N2,130,22458,23318,45776,349,15.0
kroB200.tsp,steepest-ls,random-walk,N2,142,18589,21191,39780,5024,15.0
kroB200.tsp,qc-ls,random-walk,N2,70,23620,26164,49784,281,15.0
kroA200.tsp,steepest-ls,random-walk,N2,24,17998,19389,37387,4504,15.0
kroA200.tsp,candidate-ls,random-walk,N2,14,18804,19678,38482,1394,15.0
kroB200.tsp,steepest-ls,random-walk,N2,48,20277,18931,39208,4603,15.0
kroB200.tsp,greedy-cycle,random-walk,N2,124,20857,18065,38922,2,15.0
kroB200.tsp,candidate-ls,random-walk,N2,33,19250,19775,39025,1469,15.0
kroB200.tsp,greedy-cycle,random-walk,N2,94,16866,22271,39137,3,15.0
kroA200.tsp,qc-ls,random-walk,N2,52,21853,22050,43903,284,15.0
kroB200.tsp,qc-ls,random-walk,N2,27,18617,21181,39798,343,15.0
kroA200.tsp,steepest-ls,random-walk,N2,73,21503,18295,39798,4724,15.0
kroB200.tsp,candidate-ls,random-walk,N2,104,18491,20056,38547,1562,15.0
kroA200.tsp,candidate-ls,random-walk,N2,43,22496,17166,39662,1640,15.0
kroB200.tsp,queue-ls,random-walk,N2,188,20797,22930,43727,353,15.0
kroA200.tsp,queue-ls,random-walk,N2,85,20449,21285,41734,348,15.0
kroB200.tsp,candidate-ls,random-walk,N2,64,18602,20263,38865,1457,15.0
kroB200.tsp,qc-ls,random-walk,N2,162,18998,22546,41544,389,15.0
kroA200.tsp,steepest-ls,random-walk,N2,132,18896,20129,39025,4544,15.0
kroB200.tsp,candidate-ls,random-walk,N2,112,18297,20267,38564,1501,15.0
kroA200.tsp,steepest-ls,random-walk,N2,65,18649,21025,39674,4884,15.0
kroB200.tsp,qc-ls,random-walk,N2,31,22505,21775,44280,357,15.0
kroA200.tsp,queue-ls,random-walk,N2,93,26198,23923,50121,310,15.0
kroA200.tsp,candidate-ls,random-walk,N2,55,20343,18598,38941,1448,15.0
kroB200.tsp,qc-ls,random-walk,N2,174,23033,21763,44796,374,15.0
kroB200.tsp,candidate-ls,random-walk,N2,72,18213,21559,39772,1400,15.0
kroA200.tsp,qc-ls,random-walk,N2,13,20548,18044,38592,332,15.0
kroB200.tsp,steepest-ls,random-walk,N2,4,18689,20172,38861,4747,15.0
kroA200.tsp,qc-ls,random-walk,N2,108,22110,21252,43362,349,15.0
kroA200.tsp,steepest-ls,random-walk,N2,124,20057,17964,38021,4529,15.0
kroB200.tsp,candidate-ls,random-walk,N2,3,19250,20314,39564,1620,15.0
kroA200.tsp,steepest-ls,random-walk,N2,32,18193,19598,37791,4861,15.0
kroB200.tsp,qc-ls,random-walk,N2,66,20579,20082,40661,315,15.0
kroB200.tsp,steepest-ls,random-walk,N2,154,19699,18869,38568,4877,15.0
kroB200.tsp,queue-ls,random-walk,N2,126,20119,20690,40809,350,15.0
kroB200.tsp,qc-ls,random-walk,N2,89,21118,18513,39631,353,15.0
kroA200.tsp,qc-ls,random-walk,N2,44,23434,22860,46294,299,15.0
kroB200.tsp,greedy-cycle,random-walk,N2,82,21149,18773,39922,7,15.0
kroB200.tsp,candidate-ls,random-walk,N2,25,20050,20711,40761,1566,15.0
kroA200.tsp,queue-ls,random-walk,N2,148,29549,27557,57106,320,15.0
kroB200.tsp,greedy-cycle,random-walk,N2,132,17789,20510,38299,3,15.0
kroB200.tsp,qc-ls,random-walk,N2,7,20881,21405,42286,344,15.0
kroA200.tsp,candidate-ls,random-walk,N2,79,19482,20333,39815,1417,15.0
kroB200.tsp,queue-ls,random-walk,N2,70,19782,22707,42489,346,15.0
kroA200.tsp,steepest-ls,random-walk,N2,49,20005,21301,41306,4633,15.0
kroA200.tsp,queue-ls,random-walk,N2,50,27924,26079,54003,284,15.0
kroA200.tsp,greedy-cycle,random-walk,N2,31,18374,17472,35846,2,15.0
kroA200.tsp,candidate-ls,random-walk,N2,96,19110,19958,39068,1391,15.0
kroA200.tsp,steepest-ls,random-walk,N2,108,19915,17585,37500,5072,15.0
kroA200.tsp,qc-ls,random-walk,N2,124,20400,18859,39259,340,15.0
kroA200.tsp,queue-ls,random-walk,N2,1,21592,26103,47695,303,15.0
kroA200.tsp,candidate-ls,random-walk,N2,160,19312,18852,38164,1526,15.0
kroB200.tsp,greedy-cycle,random-walk,N2,16,18884,16849,35733,2,15.0
kroB200.tsp,qc-ls,random-walk,N2,158,20830,22039,42869,362,15.0
kroB200.tsp,steepest-ls,random-walk,N2,25,19679,20200,39879,4704,15.0
kroA200.tsp,greedy-cycle,random-walk,N2,140,17168,20167,37335,2,15.0
kroB200.tsp,candidate-ls,random-walk,N2,186,19133,18878,38011,1524,15.0
kroA200.tsp,greedy-cycle,random-walk,N2,89,16943,20139,37082,2,15.0
kroA200.tsp,qc-ls,random-walk,N2,2,23500,20906,44406,333,15.0
kroA200.tsp,greedy-cycle,random-walk,N2,66,16527,21633,38160,4,15.0
kroB200.tsp,steepest-ls,random-walk,N2,178,19006,21401,40407,4753,15.0
kroB200.tsp,queue-ls,random-walk,N2,27,20338,20730,41068,419,15.0
kroB200.tsp,greedy-cycle,random-walk,N2,41,21106,17142,38248,2,15.0
kroA200.tsp,qc-ls,random-walk,N2,87,25112,23405,48517,300,15.0
kroB200.tsp,steepest-ls,random-walk,N2,72,20562,19780,40342,4583,15.0
kroA200.tsp,queue-ls,random-walk,N2,164,22231,21948,44179,332,15.0
kroA200.tsp,qc-ls,random-walk,N2,68,22613,21140,43753,305,15.0
kroA200.tsp,candidate-ls,random-walk,N2,38,19112,18437,37549,1411,15.0
kroB200.tsp,candidate-ls,random-walk,N2,190,17704,20130,37834,1781,15.0
kroA200.tsp,greedy-cycle,random-walk,N2,156,17458,22307,39765,3,15.0
kroB200.tsp,queue-ls,random-walk,N2,31,20597,19378,39975,427,15.0
kroA200.tsp,queue-ls,random-walk,N2,11,21681,23690,45371,404,15.0
kroA200.tsp,greedy-cycle,random-walk,N2,70,16872,20167,37039,2,15.0
kroA200.tsp,qc-ls,random-walk,N2,91,21523,20562,42085,446,15.0
kroB200.tsp,greedy-cycle,random-walk,N2,57,17191,21859,39050,3,15.0
kroA200.tsp,queue-ls,random-walk,N2,172,20788,18779,39567,378,15.0
kroB200.tsp,greedy-cycle,random-walk,N2,108,17812,17483,35295,3,15.0
kroB200.tsp,steepest-ls,random-walk,N2,64,21013,18446,39459,5053,15.0
kroB200.tsp,queue-ls,random-walk,N2,89,20528,22036,42564,393,15.0
kroA200.tsp,candidate-ls,random-walk,N2,80,18864,20570,39434,1354,15.0
kroA200.tsp,greedy-cycle,random-walk,N2,27,16872,20167,37039,2,15.0
kroB200.tsp,candidate-ls,random-walk,N2,128,18450,19250,37700,1762,15.0
kroA200.tsp,queue-ls,random-walk,N2,46,24073,24814,48887,260,15.0
kroB200.tsp,queue-ls,random-walk,N2,66,20725,21115,41840,346,15.0
kroA200.tsp,candidate-ls,random-walk,N2,176,20301,18002,38303,1561,15.0
kroA200.tsp,qc-ls,random-walk,N2,132,23229,22920,46149,405,15.0
kroB200.tsp,steepest-ls,random-walk,N2,33,19607,21204,40811,4697,15.0
kroA200.tsp,candidate-ls,random-walk,N2,2,19618,20634,40252,1678,15.0
kroB200.tsp,candidate-ls,random-walk,N2,48,19959,18898,38857,1477,15.0
kroA200.tsp,qc-ls,random-walk,N2,29,23415,20966,44381,481,15.0
