instance,solver,init_solver,neighbourhood,start_vertex,cost_first,cost_second,total_cost,duration
kroA100.tsp,greedy-ls,random-walk,N1,84,20168,22666,42834,176
kroA100.tsp,steepest-ls,random-walk,N2,73,13785,14230,28015,228
kroB100.tsp,steepest-ls,greedy-cycle,N1,38,11027,15534,26561,61
kroB100.tsp,greedy-ls,greedy-cycle,N2,15,14316,10331,24647,17
kroB100.tsp,steepest-ls,random-walk,N1,18,20531,21779,42310,375
kroA100.tsp,greedy-ls,random-walk,N2,94,13215,13836,27051,160
kroB100.tsp,steepest-ls,greedy-cycle,N2,28,11194,14354,25548,52
kroA100.tsp,steepest-ls,random-walk,N1,63,18707,20466,39173,296
kroA100.tsp,greedy-ls,greedy-cycle,N2,17,14157,11657,25814,17
kroA100.tsp,steepest-ls,random-walk,N2,24,13812,14171,27983,223
kroB100.tsp,greedy-ls,greedy-cycle,N1,52,12635,14757,27392,28
kroA100.tsp,greedy-ls,greedy-cycle,N1,50,11600,14330,25930,30
kroA100.tsp,steepest-ls,greedy-cycle,N2,49,15513,12386,27899,29
kroB100.tsp,steepest-ls,greedy-cycle,N1,80,11027,15534,26561,71
kroA100.tsp,steepest-ls,random-walk,N1,34,24708,17722,42430,311
kroB100.tsp,greedy-ls,greedy-cycle,N2,42,14336,10313,24649,18
kroA100.tsp,steepest-ls,greedy-cycle,N1,59,14595,11657,26252,31
kroA100.tsp,greedy-ls,greedy-cycle,N2,40,11502,14991,26493,20
kroA100.tsp,greedy-ls,greedy-cycle,N1,3,12386,15198,27584,17
kroB100.tsp,steepest-ls,greedy-cycle,N2,90,11506,14572,26078,47
kroB100.tsp,steepest-ls,random-walk,N2,49,14216,14516,28732,266
kroB100.tsp,greedy-ls,greedy-cycle,N1,44,15120,11444,26564,13
kroB100.tsp,steepest-ls,greedy-cycle,N1,79,11219,16084,27303,56
kroA100.tsp,steepest-ls,random-walk,N2,32,14048,13301,27349,232
kroB100.tsp,steepest-ls,greedy-cycle,N1,96,15985,11305,27290,36
kroA100.tsp,greedy-ls,greedy-cycle,N1,46,12386,15198,27584,19
kroB100.tsp,greedy-ls,greedy-cycle,N2,54,12420,14523,26943,19
kroB100.tsp,steepest-ls,random-walk,N1,59,18734,23096,41830,364
kroA100.tsp,steepest-ls,random-walk,N1,22,21654,21091,42745,285
kroB100.tsp,steepest-ls,greedy-cycle,N2,69,10344,13876,24220,48
kroB100.tsp,steepest-ls,greedy-cycle,N2,86,10838,15443,26281,42
kroA100.tsp,greedy-ls,greedy-cycle,N2,56,15198,12386,27584,18
kroA100.tsp,steepest-ls,random-walk,N2,65,14884,13548,28432,222
kroA100.tsp,greedy-ls,random-walk,N1,92,23800,19694,43494,167
kroB100.tsp,steepest-ls,random-walk,N1,7,22138,21591,43729,320
kroB100.tsp,greedy-ls,greedy-cycle,N1,13,14941,10577,25518,27
kroB100.tsp,greedy-ls,random-walk,N1,9,21942,18229,40171,171
kroA100.tsp,steepest-ls,random-walk,N1,5,21685,22724,44409,280
kroA100.tsp,greedy-ls,greedy-cycle,N1,11,14770,11657,26427,11
kroA100.tsp,steepest-ls,random-walk,N1,75,15786,21205,36991,283
kroA100.tsp,greedy-ls,random-walk,N2,82,15710,12517,28227,164
kroA100.tsp,steepest-ls,greedy-cycle,N1,18,14595,11657,26252,28
kroB100.tsp,greedy-ls,greedy-cycle,N1,87,12454,14231,26685,23
kroA100.tsp,steepest-ls,greedy-cycle,N2,73,11502,14991,26493,40
kroB100.tsp,steepest-ls,greedy-cycle,N1,55,15347,11907,27254,40
kroA100.tsp,greedy-ls,greedy-cycle,N1,85,11502,15434,26936,16
kroB100.tsp,greedy-ls,greedy-cycle,N1,68,12302,14610,26912,26
kroB100.tsp,greedy-ls,random-walk,N1,27,18913,19680,38593,168
kroB100.tsp,steepest-ls,random-walk,N2,65,15048,14522,29570,206
kroB100.tsp,greedy-ls,greedy-cycle,N2,97,11194,14759,25953,19
kroA100.tsp,steepest-ls,greedy-cycle,N1,63,14698,11657,26355,34
kroA100.tsp,greedy-ls,random-walk,N2,16,13379,13534,26913,160
kroB100.tsp,steepest-ls,greedy-cycle,N2,45,14882,10859,25741,62
kroA100.tsp,greedy-ls,greedy-cycle,N2,95,11657,14435,26092,15
kroB100.tsp,steepest-ls,random-walk,N1,75,19905,23262,43167,428
kroB100.tsp,greedy-ls,random-walk,N2,37,14734,14070,28804,145
kroB100.tsp,greedy-ls,greedy-cycle,N2,78,14434,11867,26301,21
kroA100.tsp,greedy-ls,random-walk,N1,51,21040,19120,40160,217
kroA100.tsp,steepest-ls,greedy-cycle,N2,24,14147,11657,25804,35
kroB100.tsp,greedy-ls,random-walk,N1,70,20043,19426,39469,150
kroB100.tsp,steepest-ls,random-walk,N2,32,13575,14131,27706,211
kroA100.tsp,steepest-ls,random-walk,N2,49,15026,12330,27356,221
kroB100.tsp,steepest-ls,random-walk,N2,2,15144,14399,29543,253
kroA100.tsp,greedy-ls,random-walk,N2,41,15180,12429,27609,162
kroA100.tsp,steepest-ls,greedy-cycle,N1,34,11713,15934,27647,41
kroB100.tsp,steepest-ls,random-walk,N1,22,16275,21562,37837,274
kroB100.tsp,greedy-ls,random-walk,N2,60,13177,13535,26712,158
kroA100.tsp,steepest-ls,random-walk,N1,59,20294,26900,47194,257
kroB100.tsp,steepest-ls,greedy-cycle,N2,12,11194,14354,25548,49
kroB100.tsp,greedy-ls,random-walk,N1,89,26513,18423,44936,139
kroA100.tsp,steepest-ls,greedy-cycle,N2,32,14428,11657,26085,31
kroA100.tsp,greedy-ls,random-walk,N1,47,20124,28666,48790,166
kroB100.tsp,steepest-ls,greedy-cycle,N1,14,14899,10763,25662,50
kroB100.tsp,greedy-ls,greedy-cycle,N1,29,11194,15678,26872,18
kroB100.tsp,greedy-ls,random-walk,N1,66,19724,22915,42639,197
kroB100.tsp,steepest-ls,random-walk,N2,24,14236,12894,27130,205
kroB100.tsp,greedy-ls,random-walk,N2,99,14665,13838,28503,175
kroA100.tsp,steepest-ls,greedy-cycle,N1,22,15486,12386,27872,41
kroA100.tsp,greedy-ls,random-walk,N2,57,14309,14237,28546,154
kroB100.tsp,steepest-ls,random-walk,N1,34,20333,21257,41590,324
kroB100.tsp,greedy-ls,random-walk,N2,76,11476,15427,26903,169
kroB100.tsp,greedy-ls,greedy-cycle,N2,39,10153,16538,26691,12
kroA100.tsp,greedy-ls,random-walk,N1,10,25151,24056,49207,163
kroA100.tsp,steepest-ls,greedy-cycle,N2,65,15198,12386,27584,34
kroB100.tsp,greedy-ls,greedy-cycle,N1,91,11194,15678,26872,20
kroA100.tsp,greedy-ls,greedy-cycle,N2,6,15513,12386,27899,12
kroB100.tsp,greedy-ls,random-walk,N1,31,17367,20394,37761,167
kroB100.tsp,steepest-ls,random-walk,N2,73,14224,12743,26967,244
kroA100.tsp,greedy-ls,greedy-cycle,N1,93,12097,13870,25967,14
kroB100.tsp,steepest-ls,greedy-cycle,N1,43,12450,13865,26315,56
kroA100.tsp,steepest-ls,greedy-cycle,N1,75,15198,12386,27584,40
kroB100.tsp,greedy-ls,greedy-cycle,N2,81,11500,16346,27846,23
kroB100.tsp,steepest-ls,random-walk,N1,63,22998,25744,48742,385
kroB100.tsp,greedy-ls,random-walk,N2,21,14841,15734,30575,149
kroA100.tsp,greedy-ls,greedy-cycle,N2,83,11713,15199,26912,23
kroB100.tsp,steepest-ls,greedy-cycle,N2,53,10153,16651,26804,21
kroA100.tsp,steepest-ls,random-walk,N1,18,21374,21001,42375,309
kroB100.tsp,steepest-ls,greedy-cycle,N2,24,14384,11305,25689,35
kroA100.tsp,greedy-ls,random-walk,N2,98,13713,14122,27835,154
kroB100.tsp,steepest-ls,random-walk,N1,14,19441,24834,44275,302
kroB100.tsp,greedy-ls,random-walk,N2,56,13383,15186,28569,165
kroB100.tsp,greedy-ls,greedy-cycle,N2,19,14679,11867,26546,24
kroA100.tsp,greedy-ls,random-walk,N2,77,13363,13648,27011,175
kroB100.tsp,steepest-ls,greedy-cycle,N2,2,14317,10353,24670,48
kroA100.tsp,steepest-ls,random-walk,N1,80,19239,25357,44596,294
kroB100.tsp,steepest-ls,greedy-cycle,N1,34,10827,16739,27566,16
kroA100.tsp,greedy-ls,random-walk,N1,88,20644,18945,39589,195
kroB100.tsp,greedy-ls,random-walk,N1,46,22430,24896,47326,151
kroA100.tsp,steepest-ls,greedy-cycle,N2,12,11713,14957,26670,44
kroA100.tsp,greedy-ls,random-walk,N1,67,21080,15763,36843,183
kroA100.tsp,steepest-ls,random-walk,N2,90,13592,15342,28934,217
kroB100.tsp,steepest-ls,random-walk,N1,43,21141,26064,47205,277
kroB100.tsp,steepest-ls,greedy-cycle,N2,73,11108,13814,24922,44
kroA100.tsp,steepest-ls,random-walk,N1,38,16861,22689,39550,335
kroA100.tsp,greedy-ls,random-walk,N2,20,12959,16757,29716,171
kroA100.tsp,steepest-ls,greedy-cycle,N1,55,11713,15934,27647,40
kroB100.tsp,greedy-ls,random-walk,N1,11,17088,20379,37467,171
kroB100.tsp,steepest-ls,random-walk,N2,53,13971,14280,28251,282
kroA100.tsp,steepest-ls,greedy-cycle,N1,7,11713,15934,27647,38
kroA100.tsp,steepest-ls,random-walk,N2,28,13969,12553,26522,227
kroB100.tsp,steepest-ls,greedy-cycle,N1,63,14408,10577,24985,52
kroA100.tsp,greedy-ls,random-walk,N2,2,12412,14335,26747,169
kroB100.tsp,greedy-ls,greedy-cycle,N2,7,10837,15611,26448,17
kroA100.tsp,greedy-ls,random-walk,N1,30,14643,22291,36934,161
kroA100.tsp,steepest-ls,greedy-cycle,N2,45,14435,11657,26092,33
kroB100.tsp,steepest-ls,greedy-cycle,N2,65,11505,16324,27829,46
kroB100.tsp,steepest-ls,random-walk,N1,55,19932,14340,34272,353
kroB100.tsp,greedy-ls,random-walk,N2,17,15466,15089,30555,132
kroB100.tsp,greedy-ls,greedy-cycle,N2,58,10837,15694,26531,16
kroA100.tsp,steepest-ls,greedy-cycle,N1,43,12386,15198,27584,39
kroA100.tsp,greedy-ls,random-walk,N2,36,12964,13277,26241,164
kroB100.tsp,steepest-ls,greedy-cycle,N1,75,11027,15534,26561,59
kroB100.tsp,greedy-ls,greedy-cycle,N1,48,14358,10970,25328,34
kroB100.tsp,steepest-ls,random-walk,N2,45,15162,12482,27644,257
kroA100.tsp,steepest-ls,greedy-cycle,N2,53,15486,12386,27872,34
kroA100.tsp,greedy-ls,random-walk,N1,26,19829,16704,36533,181
kroB100.tsp,greedy-ls,random-walk,N2,40,13446,13591,27037,166
kroA100.tsp,steepest-ls,random-walk,N1,79,22208,22296,44504,353
kroB100.tsp,steepest-ls,greedy-cycle,N2,32,11194,14354,25548,48
kroA100.tsp,steepest-ls,random-walk,N1,96,22640,22481,45121,286
kroA100.tsp,greedy-ls,random-walk,N2,61,14723,14712,29435,162
kroA100.tsp,steepest-ls,greedy-cycle,N1,14,12386,15198,27584,41
kroB100.tsp,greedy-ls,random-walk,N1,50,17448,23416,40864,200
kroB100.tsp,steepest-ls,random-walk,N2,12,13245,15141,28386,271
kroB100.tsp,greedy-ls,random-walk,N1,5,20108,19167,39275,197
kroB100.tsp,greedy-ls,greedy-cycle,N2,100,10442,13817,24259,27
kroB100.tsp,steepest-ls,greedy-cycle,N1,22,15347,11907,27254,39
kroA100.tsp,steepest-ls,random-walk,N2,69,13729,13736,27465,234
kroA100.tsp,steepest-ls,random-walk,N2,86,12470,14248,26718,222
kroA100.tsp,greedy-ls,random-walk,N1,71,21346,21618,42964,201
kroA100.tsp,steepest-ls,random-walk,N1,9,21303,22640,43943,281
kroA100.tsp,greedy-ls,greedy-cycle,N2,76,11657,14435,26092,14
kroB100.tsp,steepest-ls,random-walk,N1,96,20433,16964,37397,330
kroB100.tsp,greedy-ls,greedy-cycle,N2,74,12359,13601,25960,25
kroB100.tsp,steepest-ls,random-walk,N1,79,25258,19422,44680,357
kroA100.tsp,steepest-ls,greedy-cycle,N1,80,11860,11668,23528,64
kroA100.tsp,greedy-ls,greedy-cycle,N2,99,14435,11657,26092,16
kroB100.tsp,steepest-ls,greedy-cycle,N2,49,10838,15443,26281,42
kroA100.tsp,greedy-ls,greedy-cycle,N1,66,15198,12386,27584,22
kroB100.tsp,steepest-ls,random-walk,N2,86,14969,14398,29367,220
kroB100.tsp,steepest-ls,random-walk,N2,69,13521,14832,28353,230
kroB100.tsp,greedy-ls,greedy-cycle,N1,64,14899,10763,25662,28
kroA100.tsp,greedy-ls,greedy-cycle,N1,89,13485,12074,25559,24
kroA100.tsp,steepest-ls,greedy-cycle,N2,90,15513,12386,27899,27
kroA100.tsp,greedy-ls,greedy-cycle,N2,100,12386,15198,27584,15
kroB100.tsp,steepest-ls,greedy-cycle,N1,59,11205,15678,26883,31
kroA100.tsp,steepest-ls,random-walk,N2,12,14941,13392,28333,238
kroB100.tsp,greedy-ls,random-walk,N2,83,13642,13360,27002,171
kroA100.tsp,greedy-ls,greedy-cycle,N2,21,14435,11657,26092,13
kroA100.tsp,steepest-ls,greedy-cycle,N1,38,14581,11657,26238,27
kroA100.tsp,steepest-ls,random-walk,N1,55,21775,18796,40571,300
kroB100.tsp,greedy-ls,greedy-cycle,N2,23,14987,11907,26894,19
kroB100.tsp,greedy-ls,random-walk,N1,93,18158,17902,36060,190
kroA100.tsp,steepest-ls,greedy-cycle,N2,28,13353,12498,25851,37
kroA100.tsp,greedy-ls,greedy-cycle,N1,31,13485,12074,25559,25
kroA100.tsp,steepest-ls,random-walk,N2,45,15350,15090,30440,217
kroB100.tsp,greedy-ls,greedy-cycle,N1,33,14317,11126,25443,17
kroA100.tsp,greedy-ls,greedy-cycle,N2,37,11625,15579,27204,26
kroB100.tsp,greedy-ls,random-walk,N2,95,13667,14387,28054,148
kroB100.tsp,greedy-ls,greedy-cycle,N2,35,10827,15820,26647,16
kroB100.tsp,steepest-ls,random-walk,N1,38,18756,24394,43150,337
kroA100.tsp,steepest-ls,random-walk,N1,43,23481,19436,42917,320
kroA100.tsp,greedy-ls,greedy-cycle,N1,27,11429,14959,26388,21
kroB100.tsp,greedy-ls,random-walk,N1,85,20528,19689,40217,189
kroB100.tsp,steepest-ls,random-walk,N2,28,14705,15121,29826,232
kroB100.tsp,greedy-ls,greedy-cycle,N1,25,10827,16739,27566,9
kroB100.tsp,steepest-ls,greedy-cycle,N1,7,10826,16765,27591,20
kroA100.tsp,steepest-ls,random-walk,N2,53,14430,12524,26954,273
kroB100.tsp,steepest-ls,greedy-cycle,N1,18,15576,11305,26881,40
kroB100.tsp,steepest-ls,random-walk,N1,80,25566,21478,47044,386
kroA100.tsp,steepest-ls,greedy-cycle,N1,79,15486,12386,27872,39
kroA100.tsp,steepest-ls,greedy-cycle,N2,2,11502,14991,26493,38
kroA100.tsp,greedy-ls,greedy-cycle,N2,60,11762,15533,27295,12
kroA100.tsp,steepest-ls,random-walk,N1,14,23328,16274,39602,307
kroA100.tsp,greedy-ls,random-walk,N1,7,20617,20625,41242,161
kroA100.tsp,steepest-ls,greedy-cycle,N1,96,11502,15434,26936,45
kroB100.tsp,greedy-ls,greedy-cycle,N2,62,10344,13895,24239,22
kroB100.tsp,greedy-ls,greedy-cycle,N1,2,14941,11256,26197,15
kroB100.tsp,steepest-ls,random-walk,N2,90,14114,15255,29369,222
kroA100.tsp,greedy-ls,greedy-cycle,N1,70,15486,12386,27872,14
kroA100.tsp,steepest-ls,greedy-cycle,N2,69,11502,14991,26493,38
kroA100.tsp,steepest-ls,greedy-cycle,N2,86,11713,14957,26670,42
kroB100.tsp,greedy-ls,greedy-cycle,N1,72,11449,17064,28513,14
kroB100.tsp,steepest-ls,random-walk,N2,91,15053,13705,28758,224
kroA100.tsp,steepest-ls,greedy-cycle,N2,68,11502,14424,25926,47
kroA100.tsp,greedy-ls,greedy-cycle,N1,71,12386,15198,27584,18
kroA100.tsp,steepest-ls,greedy-cycle,N2,87,11698,14957,26655,45
kroB100.tsp,greedy-ls,greedy-cycle,N1,73,11119,15138,26257,12
kroB100.tsp,steepest-ls,random-walk,N1,81,15687,22865,38552,369
kroA100.tsp,steepest-ls,greedy-cycle,N2,3,12386,15198,27584,34
kroA100.tsp,greedy-ls,greedy-cycle,N2,61,11654,15676,27330,14
kroA100.tsp,steepest-ls,greedy-cycle,N1,78,11502,15434,26936,40
kroA100.tsp,steepest-ls,random-walk,N1,15,21300,24874,46174,300
kroA100.tsp,greedy-ls,random-walk,N1,6,19745,22806,42551,178
kroA100.tsp,steepest-ls,greedy-cycle,N1,97,15198,12386,27584,39
kroB100.tsp,greedy-ls,greedy-cycle,N2,63,14204,11065,25269,37
kroB100.tsp,greedy-ls,greedy-cycle,N1,3,11119,15138,26257,13
kroA100.tsp,greedy-ls,greedy-cycle,N1,26,15198,12386,27584,18
kroB100.tsp,greedy-ls,random-walk,N1,84,20313,22281,42594,174
kroB100.tsp,steepest-ls,random-walk,N2,29,14143,13582,27725,229
kroB100.tsp,greedy-ls,greedy-cycle,N1,24,15463,11305,26768,22
kroB100.tsp,steepest-ls,greedy-cycle,N1,6,14317,10763,25080,47
kroA100.tsp,steepest-ls,random-walk,N2,52,13628,12952,26580,232
kroB100.tsp,steepest-ls,greedy-cycle,N1,19,15985,11305,27290,40
kroA100.tsp,greedy-ls,greedy-cycle,N2,36,14435,11657,26092,18
kroB100.tsp,greedy-ls,random-walk,N2,94,15113,14712,29825,151
kroB100.tsp,greedy-ls,greedy-cycle,N2,34,10827,15547,26374,20
kroB100.tsp,steepest-ls,random-walk,N1,39,17505,23494,40999,292
kroA100.tsp,steepest-ls,random-walk,N1,42,26313,21784,48097,319
kroB100.tsp,greedy-ls,random-walk,N1,92,20930,18656,39586,165
kroA100.tsp,greedy-ls,greedy-cycle,N1,30,12333,15086,27419,18
kroA100.tsp,steepest-ls,greedy-cycle,N2,29,12386,15198,27584,31
kroA100.tsp,steepest-ls,random-walk,N2,44,13927,13514,27441,232
kroB100.tsp,greedy-ls,greedy-cycle,N1,32,11194,15678,26872,15
kroB100.tsp,greedy-ls,random-walk,N2,82,14939,12803,27742,158
kroA100.tsp,steepest-ls,greedy-cycle,N1,39,12333,15083,27416,42
kroA100.tsp,greedy-ls,greedy-cycle,N2,20,11713,15039,26752,18
kroB100.tsp,greedy-ls,random-walk,N2,1,13053,13756,26809,170
kroA100.tsp,steepest-ls,random-walk,N1,54,24847,26286,51133,251
kroB100.tsp,greedy-ls,greedy-cycle,N2,22,15010,11751,26761,23
kroA100.tsp,greedy-ls,greedy-cycle,N1,67,13148,12661,25809,22
kroB100.tsp,steepest-ls,random-walk,N2,87,14033,14132,28165,223
kroB100.tsp,steepest-ls,random-walk,N2,68,13739,14135,27874,242
kroB100.tsp,greedy-ls,greedy-cycle,N1,65,11792,16815,28607,21
kroA100.tsp,steepest-ls,greedy-cycle,N2,91,14435,11657,26092,35
kroA100.tsp,greedy-ls,greedy-cycle,N1,88,15489,12386,27875,16
kroB100.tsp,greedy-ls,random-walk,N2,100,15455,13932,29387,166
kroB100.tsp,steepest-ls,greedy-cycle,N1,58,10826,16765,27591,21
kroA100.tsp,steepest-ls,random-walk,N2,13,15282,14178,29460,226
kroA100.tsp,greedy-ls,greedy-cycle,N2,77,11720,15683,27403,21
kroB100.tsp,steepest-ls,random-walk,N1,97,21536,19401,40937,303
kroB100.tsp,greedy-ls,greedy-cycle,N2,75,10537,15207,25744,18
kroB100.tsp,steepest-ls,random-walk,N1,78,16539,20180,36719,338
kroA100.tsp,greedy-ls,greedy-cycle,N2,98,14507,11657,26164,16
kroA100.tsp,steepest-ls,greedy-cycle,N1,81,11698,16222,27920,33
kroB100.tsp,steepest-ls,greedy-cycle,N2,48,14317,10353,24670,38
kroB100.tsp,greedy-ls,random-walk,N1,4,20745,17722,38467,173
kroB100.tsp,greedy-ls,random-walk,N1,51,15636,19217,34853,187
kroB100.tsp,steepest-ls,random-walk,N2,13,14960,13054,28014,209
kroB100.tsp,steepest-ls,greedy-cycle,N1,23,15347,11907,27254,41
kroA100.tsp,steepest-ls,random-walk,N2,68,14230,14436,28666,223
kroA100.tsp,steepest-ls,random-walk,N2,87,14065,12463,26528,231
kroA100.tsp,greedy-ls,random-walk,N1,70,23683,16747,40430,183
kroA100.tsp,steepest-ls,random-walk,N1,8,18464,17816,36280,317
kroB100.tsp,greedy-ls,random-walk,N2,41,12874,14757,27631,159
kroA100.tsp,steepest-ls,random-walk,N1,78,22695,21962,44657,308
kroB100.tsp,steepest-ls,greedy-cycle,N2,33,14317,10353,24670,38
kroA100.tsp,steepest-ls,random-walk,N1,97,20565,18282,38847,331
kroA100.tsp,greedy-ls,random-walk,N2,60,15383,13621,29004,166
kroA100.tsp,steepest-ls,greedy-cycle,N1,15,14770,11657,26427,30
kroB100.tsp,steepest-ls,greedy-cycle,N1,74,12450,13865,26315,56
kroB100.tsp,greedy-ls,greedy-cycle,N1,49,11250,15415,26665,25
kroB100.tsp,steepest-ls,random-walk,N2,44,14757,12891,27648,255
kroA100.tsp,steepest-ls,greedy-cycle,N2,52,11502,14424,25926,49
kroA100.tsp,greedy-ls,random-walk,N1,27,21110,22772,43882,172
kroB100.tsp,steepest-ls,greedy-cycle,N2,64,14017,10353,24370,56
kroB100.tsp,steepest-ls,random-walk,N1,54,20077,19198,39275,358
kroB100.tsp,greedy-ls,random-walk,N2,16,14959,13099,28058,190
kroB100.tsp,greedy-ls,greedy-cycle,N2,59,11194,14354,25548,24
kroA100.tsp,steepest-ls,greedy-cycle,N1,42,11860,11668,23528,67
kroA100.tsp,greedy-ls,random-walk,N2,37,15386,15657,31043,145
kroB100.tsp,greedy-ls,random-walk,N1,10,17318,22591,39909,188
kroB100.tsp,steepest-ls,random-walk,N2,52,14428,14103,28531,241
kroA100.tsp,steepest-ls,greedy-cycle,N1,6,15513,12386,27899,33
kroA100.tsp,steepest-ls,random-walk,N2,29,13336,14052,27388,227
kroB100.tsp,steepest-ls,greedy-cycle,N1,62,10730,14227,24957,56
kroA100.tsp,greedy-ls,random-walk,N2,3,13195,13327,26522,169
kroA100.tsp,greedy-ls,random-walk,N1,31,23366,18465,41831,183
kroB100.tsp,greedy-ls,greedy-cycle,N2,6,14317,10597,24914,22
kroA100.tsp,steepest-ls,greedy-cycle,N2,44,11502,14991,26493,40
kroB100.tsp,steepest-ls,random-walk,N1,42,25506,18974,44480,239
kroB100.tsp,steepest-ls,greedy-cycle,N2,72,10628,17104,27732,31
kroA100.tsp,steepest-ls,random-walk,N1,39,19765,22006,41771,329
kroA100.tsp,greedy-ls,random-walk,N2,21,14929,14549,29478,166
kroA100.tsp,steepest-ls,greedy-cycle,N1,54,11600,14330,25930,57
kroB100.tsp,steepest-ls,greedy-cycle,N1,35,10827,16739,27566,18
kroA100.tsp,greedy-ls,random-walk,N1,89,23554,17393,40947,142
kroB100.tsp,greedy-ls,random-walk,N1,47,19362,24108,43470,159
kroA100.tsp,steepest-ls,greedy-cycle,N2,13,11657,14435,26092,29
kroA100.tsp,greedy-ls,random-walk,N1,66,21855,18474,40329,196
kroA100.tsp,steepest-ls,random-walk,N2,91,13540,12920,26460,247
kroB100.tsp,steepest-ls,greedy-cycle,N2,25,10827,15415,26242,36
kroA100.tsp,greedy-ls,random-walk,N2,99,13091,17402,30493,155
kroB100.tsp,steepest-ls,random-walk,N1,15,19554,22077,41631,341
kroB100.tsp,greedy-ls,random-walk,N2,57,15279,15576,30855,150
kroB100.tsp,greedy-ls,greedy-cycle,N2,18,14049,11222,25271,29
kroB100.tsp,steepest-ls,greedy-cycle,N2,3,11108,13814,24922,44
kroA100.tsp,greedy-ls,random-walk,N2,76,14439,12940,27379,154
kroA100.tsp,steepest-ls,random-walk,N1,81,23374,22470,45844,378
kroA100.tsp,steepest-ls,greedy-cycle,N1,74,14595,11657,26252,33
kroB100.tsp,greedy-ls,greedy-cycle,N2,80,9291,15111,24402,26
kroB100.tsp,steepest-ls,random-walk,N1,62,19516,23045,42561,319
kroB100.tsp,greedy-ls,random-walk,N2,20,13585,13578,27163,161
kroA100.tsp,greedy-ls,greedy-cycle,N2,82,11657,14435,26092,14
kroB100.tsp,steepest-ls,greedy-cycle,N2,52,12420,14523,26943,33
kroA100.tsp,steepest-ls,random-walk,N1,19,23818,19065,42883,323
kroA100.tsp,greedy-ls,random-walk,N1,11,21070,19003,40073,168
kroA100.tsp,steepest-ls,greedy-cycle,N2,64,11502,14991,26493,39
kroB100.tsp,greedy-ls,greedy-cycle,N1,90,12220,15905,28125,21
kroB100.tsp,greedy-ls,random-walk,N1,30,17869,21531,39400,207
kroB100.tsp,steepest-ls,random-walk,N2,72,15592,14959,30551,242
kroA100.tsp,greedy-ls,greedy-cycle,N2,7,11713,15542,27255,17
kroA100.tsp,greedy-ls,greedy-cycle,N1,92,13485,12074,25559,25
kroB100.tsp,steepest-ls,greedy-cycle,N1,42,14408,10577,24985,55
kroB100.tsp,greedy-ls,random-walk,N2,98,14707,13992,28699,160
kroA100.tsp,steepest-ls,greedy-cycle,N1,23,14770,11657,26427,31
kroA100.tsp,greedy-ls,random-walk,N2,56,14964,13509,28473,165
kroB100.tsp,steepest-ls,random-walk,N1,35,16376,18797,35173,355
kroB100.tsp,greedy-ls,random-walk,N2,77,13462,13486,26948,178
kroB100.tsp,greedy-ls,greedy-cycle,N2,38,10619,15210,25829,21
kroB100.tsp,greedy-ls,random-walk,N1,88,18783,25990,44773,188
kroA100.tsp,steepest-ls,greedy-cycle,N2,33,11657,14435,26092,29
kroA100.tsp,greedy-ls,random-walk,N1,46,22469,19599,42068,192
kroB100.tsp,steepest-ls,greedy-cycle,N1,15,14317,10763,25080,43
kroB100.tsp,greedy-ls,greedy-cycle,N1,28,11205,15678,26883,15
kroB100.tsp,greedy-ls,random-walk,N1,67,18937,17830,36767,169
kroB100.tsp,steepest-ls,random-walk,N2,25,13868,13014,26882,231
kroB100.tsp,steepest-ls,random-walk,N2,3,14693,13737,28430,259
kroA100.tsp,greedy-ls,random-walk,N2,40,14439,15154,29593,155
kroA100.tsp,steepest-ls,greedy-cycle,N1,35,11713,15934,27647,39
kroB100.tsp,steepest-ls,random-walk,N1,23,16414,19197,35611,272
kroB100.tsp,greedy-ls,random-walk,N2,61,14668,13710,28378,195
kroA100.tsp,steepest-ls,random-walk,N2,1,13200,12223,25423,262
kroA100.tsp,steepest-ls,random-walk,N1,58,19664,18769,38433,264
kroB100.tsp,steepest-ls,greedy-cycle,N2,13,14317,10353,24670,40
kroA100.tsp,greedy-ls,random-walk,N1,50,24823,21237,46060,161
kroA100.tsp,steepest-ls,greedy-cycle,N2,25,11698,15245,26943,44
kroB100.tsp,greedy-ls,random-walk,N1,71,19585,22512,42097,216
kroB100.tsp,steepest-ls,random-walk,N2,33,15183,13014,28197,243
kroA100.tsp,steepest-ls,random-walk,N2,48,14403,14745,29148,197
kroB100.tsp,greedy-ls,greedy-cycle,N2,96,14936,10996,25932,29
kroA100.tsp,steepest-ls,greedy-cycle,N1,62,11915,15550,27465,36
kroA100.tsp,greedy-ls,random-walk,N2,17,14804,14923,29727,168
kroB100.tsp,steepest-ls,greedy-cycle,N2,44,14060,11444,25504,41
kroA100.tsp,greedy-ls,greedy-cycle,N2,94,15489,12386,27875,15
kroB100.tsp,steepest-ls,random-walk,N1,74,19619,22197,41816,358
kroB100.tsp,greedy-ls,random-walk,N2,36,15115,14515,29630,145
kroB100.tsp,greedy-ls,greedy-cycle,N2,79,11367,16364,27731,19
kroB100.tsp,greedy-ls,greedy-cycle,N1,86,11250,15302,26552,23
kroA100.tsp,steepest-ls,greedy-cycle,N2,72,14435,11657,26092,30
kroB100.tsp,steepest-ls,greedy-cycle,N1,54,12635,14757,27392,44
kroA100.tsp,greedy-ls,greedy-cycle,N1,84,14581,11657,26238,14
kroB100.tsp,greedy-ls,greedy-cycle,N1,69,10541,13854,24395,24
kroB100.tsp,greedy-ls,random-walk,N1,26,17050,22605,39655,181
kroB100.tsp,steepest-ls,random-walk,N2,64,14910,13694,28604,237
kroA100.tsp,steepest-ls,random-walk,N1,74,25113,20579,45692,288
kroA100.tsp,greedy-ls,random-walk,N2,83,13987,13608,27595,167
kroA100.tsp,steepest-ls,greedy-cycle,N1,19,15198,12386,27584,41
kroA100.tsp,steepest-ls,random-walk,N2,64,13993,15624,29617,208
kroA100.tsp,greedy-ls,random-walk,N1,93,14898,17323,32221,163
kroB100.tsp,steepest-ls,random-walk,N1,6,23391,19949,43340,337
kroB100.tsp,greedy-ls,greedy-cycle,N1,12,11194,15678,26872,20
kroB100.tsp,greedy-ls,random-walk,N1,8,24129,18166,42295,146
kroA100.tsp,steepest-ls,random-walk,N1,4,25759,20471,46230,325
kroA100.tsp,greedy-ls,greedy-cycle,N1,10,14595,11657,26252,17
kroB100.tsp,greedy-ls,greedy-cycle,N2,55,15163,11907,27070,18
kroB100.tsp,steepest-ls,random-walk,N1,58,17884,25554,43438,316
kroA100.tsp,steepest-ls,random-walk,N1,23,19074,22246,41320,381
kroB100.tsp,steepest-ls,greedy-cycle,N2,68,10896,15873,26769,44
kroB100.tsp,steepest-ls,greedy-cycle,N2,87,12450,13601,26051,52
kroA100.tsp,greedy-ls,greedy-cycle,N2,57,11713,15542,27255,13
kroB100.tsp,steepest-ls,random-walk,N2,48,14481,14741,29222,272
kroB100.tsp,greedy-ls,greedy-cycle,N1,45,16646,10943,27589,20
kroB100.tsp,steepest-ls,greedy-cycle,N1,78,15576,11305,26881,40
kroA100.tsp,steepest-ls,random-walk,N2,33,13600,14742,28342,221
kroB100.tsp,steepest-ls,greedy-cycle,N1,97,11205,15678,26883,34
kroA100.tsp,greedy-ls,greedy-cycle,N1,47,14995,11657,26652,13
kroA100.tsp,steepest-ls,random-walk,N1,35,19354,25631,44985,356
kroB100.tsp,greedy-ls,greedy-cycle,N2,43,12383,14218,26601,20
kroA100.tsp,greedy-ls,greedy-cycle,N2,41,12386,15198,27584,17
kroA100.tsp,steepest-ls,greedy-cycle,N1,58,11480,15146,26626,43
kroA100.tsp,greedy-ls,greedy-cycle,N1,2,11600,14330,25930,26
kroB100.tsp,steepest-ls,greedy-cycle,N2,91,11194,14354,25548,49
kroA100.tsp,steepest-ls,random-walk,N2,25,14885,13984,28869,247
kroB100.tsp,greedy-ls,greedy-cycle,N1,53,10342,16742,27084,13
kroA100.tsp,steepest-ls,greedy-cycle,N2,48,12386,15198,27584,40
kroA100.tsp,greedy-ls,greedy-cycle,N1,51,11698,15934,27632,18
kroB100.tsp,steepest-ls,greedy-cycle,N1,81,11219,16084,27303,54
kroB100.tsp,greedy-ls,greedy-cycle,N2,14,14230,10209,24439,30
kroB100.tsp,steepest-ls,random-walk,N1,19,22685,19811,42496,321
kroA100.tsp,greedy-ls,random-walk,N2,95,12856,13531,26387,177
kroB100.tsp,steepest-ls,greedy-cycle,N2,29,11194,14354,25548,50
kroA100.tsp,steepest-ls,random-walk,N1,62,26099,26483,52582,307
kroA100.tsp,greedy-ls,greedy-cycle,N2,16,15513,12386,27899,17
kroA100.tsp,greedy-ls,random-walk,N1,85,20893,18170,39063,184
kroA100.tsp,steepest-ls,random-walk,N2,72,13555,13985,27540,213
kroB100.tsp,steepest-ls,greedy-cycle,N1,39,10342,16742,27084,29
kroB100.tsp,steepest-ls,random-walk,N1,12,19164,20301,39465,348
kroB100.tsp,greedy-ls,random-walk,N2,50,14358,14537,28895,157
kroB100.tsp,steepest-ls,greedy-cycle,N2,22,14968,11907,26875,47
kroA100.tsp,steepest-ls,random-walk,N1,69,20788,16962,37750,272
kroA100.tsp,greedy-ls,random-walk,N2,71,13489,14050,27539,156
kroB100.tsp,steepest-ls,greedy-cycle,N2,4,14317,10353,24670,36
kroA100.tsp,steepest-ls,random-walk,N1,86,22906,18607,41513,277
kroB100.tsp,greedy-ls,random-walk,N1,40,17282,21747,39029,191
kroA100.tsp,steepest-ls,random-walk,N2,79,13406,13943,27349,218
kroB100.tsp,steepest-ls,greedy-cycle,N1,32,11205,15678,26883,31
kroA100.tsp,greedy-ls,random-walk,N1,61,18935,21032,39967,204
kroA100.tsp,steepest-ls,random-walk,N2,96,13475,14224,27699,238
kroA100.tsp,steepest-ls,greedy-cycle,N2,14,12386,15198,27584,33
kroB100.tsp,steepest-ls,greedy-cycle,N2,75,10838,15443,26281,44
kroB100.tsp,steepest-ls,random-walk,N1,45,22540,17572,40112,315
kroB100.tsp,greedy-ls,greedy-cycle,N2,48,14204,10155,24359,23
kroA100.tsp,steepest-ls,greedy-cycle,N1,53,15486,12386,27872,47
kroA100.tsp,greedy-ls,random-walk,N2,26,17031,14332,31363,171
kroA100.tsp,greedy-ls,greedy-cycle,N1,9,11669,16156,27825,17
kroB100.tsp,steepest-ls,greedy-cycle,N1,65,11219,16084,27303,51
kroA100.tsp,steepest-ls,greedy-cycle,N1,1,12532,11649,24181,56
kroB100.tsp,greedy-ls,greedy-cycle,N1,58,10826,16765,27591,10
kroB100.tsp,greedy-ls,random-walk,N1,17,21091,19592,40683,218
kroB100.tsp,steepest-ls,random-walk,N2,55,14152,15276,29428,255
kroB100.tsp,steepest-ls,random-walk,N2,100,13370,14236,27606,239
kroA100.tsp,steepest-ls,greedy-cycle,N2,43,12386,15198,27584,32
kroA100.tsp,greedy-ls,random-walk,N2,4,15583,13674,29257,171
kroB100.tsp,greedy-ls,greedy-cycle,N2,1,11648,15082,26730,24
kroA100.tsp,greedy-ls,random-walk,N1,36,20745,19398,40143,175
kroB100.tsp,steepest-ls,random-walk,N1,53,23179,16533,39712,246
kroB100.tsp,greedy-ls,random-walk,N2,11,14615,13107,27722,157
kroA100.tsp,steepest-ls,random-walk,N1,28,20910,16292,37202,301
kroB100.tsp,steepest-ls,greedy-cycle,N2,63,14317,10353,24670,39
kroA100.tsp,greedy-ls,random-walk,N2,30,15620,14821,30441,149
kroA100.tsp,steepest-ls,greedy-cycle,N1,45,14770,11657,26427,27
kroB100.tsp,steepest-ls,random-walk,N2,43,14649,13244,27893,227
kroB100.tsp,steepest-ls,greedy-cycle,N1,73,11119,15138,26257,28
kroA100.tsp,steepest-ls,random-walk,N2,38,15650,14016,29666,236
kroA100.tsp,greedy-ls,random-walk,N1,20,20782,25299,46081,157
kroA100.tsp,steepest-ls,greedy-cycle,N2,55,11713,14957,26670,47
kroA100.tsp,greedy-ls,random-walk,N2,88,13859,14275,28134,161
kroB100.tsp,steepest-ls,greedy-cycle,N2,34,10827,15415,26242,35
kroB100.tsp,greedy-ls,random-walk,N2,46,13666,15206,28872,171
kroA100.tsp,steepest-ls,greedy-cycle,N1,12,11713,15934,27647,40
kroA100.tsp,steepest-ls,random-walk,N1,90,20110,20529,40639,374
kroA100.tsp,greedy-ls,random-walk,N2,67,14734,14619,29353,161
kroA100.tsp,greedy-ls,random-walk,N1,98,17481,17866,35347,185
kroB100.tsp,steepest-ls,greedy-cycle,N1,24,15576,11305,26881,44
kroB100.tsp,greedy-ls,greedy-cycle,N1,19,15219,11222,26441,29
kroB100.tsp,greedy-ls,random-walk,N1,56,19075,16982,36057,200
kroB100.tsp,steepest-ls,random-walk,N2,14,13636,14312,27948,234
kroB100.tsp,steepest-ls,greedy-cycle,N2,100,10344,13876,24220,57
kroB100.tsp,greedy-ls,random-walk,N1,3,22230,24428,46658,153
kroA100.tsp,steepest-ls,random-walk,N2,80,14394,13462,27856,213
kroA100.tsp,greedy-ls,random-walk,N1,77,18463,19614,38077,176
kroA100.tsp,greedy-ls,greedy-cycle,N2,70,15489,12386,27875,16
kroA100.tsp,steepest-ls,greedy-cycle,N1,69,11600,14330,25930,58
kroB100.tsp,steepest-ls,random-walk,N1,90,18044,23523,41567,354
kroB100.tsp,greedy-ls,greedy-cycle,N2,72,10628,17123,27751,18
kroA100.tsp,steepest-ls,greedy-cycle,N1,86,11713,15934,27647,39
kroA100.tsp,steepest-ls,greedy-cycle,N2,79,15486,12386,27872,33
kroA100.tsp,greedy-ls,greedy-cycle,N1,60,11822,15560,27382,17
kroB100.tsp,steepest-ls,random-walk,N2,80,15227,14155,29382,204
kroA100.tsp,steepest-ls,random-walk,N2,14,13783,13255,27038,247
kroB100.tsp,greedy-ls,greedy-cycle,N1,62,10541,13967,24508,25
kroA100.tsp,steepest-ls,greedy-cycle,N2,96,11502,14424,25926,50
kroB100.tsp,greedy-ls,random-walk,N2,6,16160,12819,28979,147
kroB100.tsp,steepest-ls,random-walk,N2,8,12425,14171,26596,190
kroB100.tsp,greedy-ls,random-walk,N2,85,15579,14176,29755,158
kroA100.tsp,greedy-ls,greedy-cycle,N2,27,11669,15370,27039,22
kroB100.tsp,greedy-ls,greedy-cycle,N2,25,10827,15547,26374,24
kroB100.tsp,steepest-ls,random-walk,N1,28,22336,19146,41482,308
kroA100.tsp,steepest-ls,random-walk,N1,53,21795,24920,46715,312
kroB100.tsp,steepest-ls,greedy-cycle,N2,18,14384,11305,25689,37
kroB100.tsp,greedy-ls,random-walk,N1,95,17647,21589,39236,198
kroA100.tsp,greedy-ls,greedy-cycle,N1,37,11502,15437,26939,19
kroB100.tsp,steepest-ls,random-walk,N2,38,12840,13804,26644,227
kroB100.tsp,greedy-ls,greedy-cycle,N1,35,10827,16739,27566,7
kroA100.tsp,steepest-ls,random-walk,N2,43,14120,14866,28986,207
kroA100.tsp,steepest-ls,greedy-cycle,N1,28,13148,12828,25976,40
kroA100.tsp,greedy-ls,greedy-cycle,N2,31,13485,12074,25559,21
kroB100.tsp,greedy-ls,random-walk,N2,93,14142,16531,30673,170
kroA100.tsp,steepest-ls,random-walk,N1,45,20992,23008,44000,271
kroB100.tsp,greedy-ls,greedy-cycle,N2,33,14204,10353,24557,16
kroA100.tsp,greedy-ls,greedy-cycle,N1,21,14581,11657,26238,18
kroA100.tsp,steepest-ls,greedy-cycle,N2,38,14435,11657,26092,28
kroB100.tsp,greedy-ls,random-walk,N1,83,27065,15220,42285,185
kroA100.tsp,steepest-ls,random-walk,N2,55,13997,13961,27958,214
kroB100.tsp,greedy-ls,greedy-cycle,N1,23,15176,11907,27083,24
kroB100.tsp,steepest-ls,greedy-cycle,N1,1,12212,15896,28108,39
kroB100.tsp,steepest-ls,random-walk,N1,86,23668,19211,42879,311
kroA100.tsp,steepest-ls,greedy-cycle,N2,4,15198,12386,27584,35
kroA100.tsp,greedy-ls,greedy-cycle,N2,66,15198,12386,27584,14
kroA100.tsp,greedy-ls,greedy-cycle,N2,89,11860,11629,23489,33
kroA100.tsp,steepest-ls,greedy-cycle,N1,90,15513,12386,27899,33
kroA100.tsp,greedy-ls,random-walk,N1,1,22703,20278,42981,219
kroB100.tsp,greedy-ls,greedy-cycle,N1,4,14204,11932,26136,24
kroB100.tsp,greedy-ls,greedy-cycle,N2,64,14689,10353,25042,24
kroB100.tsp,steepest-ls,random-walk,N1,69,21663,20636,42299,352
kroB100.tsp,steepest-ls,greedy-cycle,N2,59,11194,14354,25548,48
kroA100.tsp,steepest-ls,random-walk,N1,12,20257,21113,41370,339
kroB100.tsp,steepest-ls,random-walk,N2,96,14105,14535,28640,236
kroA100.tsp,greedy-ls,greedy-cycle,N1,76,11657,14581,26238,12
kroA100.tsp,steepest-ls,greedy-cycle,N2,80,11860,10969,22829,71
kroA100.tsp,greedy-ls,greedy-cycle,N1,99,14581,11657,26238,12
kroB100.tsp,steepest-ls,random-walk,N2,79,13893,13153,27046,229
kroB100.tsp,greedy-ls,greedy-cycle,N1,74,12268,13868,26136,24
kroB100.tsp,steepest-ls,greedy-cycle,N1,49,11027,15534,26561,58
kroA100.tsp,greedy-ls,random-walk,N1,82,19226,20605,39831,203
kroA100.tsp,steepest-ls,random-walk,N2,75,13034,13517,26551,243
kroA100.tsp,steepest-ls,greedy-cycle,N2,18,14147,11657,25804,39
kroA100.tsp,greedy-ls,random-walk,N2,92,14101,14757,28858,145
kroA100.tsp,steepest-ls,random-walk,N1,65,24744,21727,46471,381
kroB100.tsp,greedy-ls,greedy-cycle,N2,13,14317,9836,24153,22
kroA100.tsp,greedy-ls,greedy-cycle,N2,11,14514,11657,26171,17
kroB100.tsp,steepest-ls,greedy-cycle,N2,8,11194,14354,25548,49
kroB100.tsp,steepest-ls,random-walk,N2,59,13689,13268,26957,251
kroB100.tsp,greedy-ls,greedy-cycle,N1,54,12635,14798,27433,20
kroA100.tsp,steepest-ls,random-walk,N2,22,13388,12548,25936,213
kroB100.tsp,steepest-ls,greedy-cycle,N1,69,10730,14227,24957,58
kroB100.tsp,steepest-ls,greedy-cycle,N1,86,11027,15534,26561,58
kroA100.tsp,greedy-ls,random-walk,N2,8,14629,14518,29147,170
kroA100.tsp,greedy-ls,greedy-cycle,N1,56,15198,12386,27584,16
kroB100.tsp,greedy-ls,greedy-cycle,N2,44,14074,11444,25518,26
kroB100.tsp,steepest-ls,random-walk,N1,49,21524,23200,44724,276
kroB100.tsp,steepest-ls,greedy-cycle,N2,79,11505,16324,27829,42
kroA100.tsp,steepest-ls,random-walk,N1,32,21787,20247,42034,305
kroA100.tsp,greedy-ls,greedy-cycle,N1,5,11600,14217,25817,25
kroB100.tsp,steepest-ls,greedy-cycle,N2,96,14206,11305,25511,46
kroA100.tsp,greedy-ls,greedy-cycle,N2,46,12386,15198,27584,15
kroA100.tsp,steepest-ls,random-walk,N2,34,13583,14151,27734,232
kroB100.tsp,greedy-ls,greedy-cycle,N1,42,14572,10566,25138,30
kroA100.tsp,steepest-ls,greedy-cycle,N2,59,14147,11657,25804,36
kroA100.tsp,greedy-ls,greedy-cycle,N1,40,11625,16077,27702,18
kroB100.tsp,steepest-ls,greedy-cycle,N1,90,12212,15896,28108,39
kroA100.tsp,steepest-ls,random-walk,N1,24,23264,23613,46877,314
kroB100.tsp,greedy-ls,greedy-cycle,N2,52,12420,14523,26943,14
kroA100.tsp,greedy-ls,greedy-cycle,N2,50,11696,16057,27753,23
kroA100.tsp,steepest-ls,greedy-cycle,N1,49,15513,12386,27899,37
kroB100.tsp,steepest-ls,greedy-cycle,N2,80,10838,15443,26281,47
kroB100.tsp,steepest-ls,random-walk,N1,1,22653,23877,46530,381
kroB100.tsp,steepest-ls,random-walk,N2,18,14163,13750,27913,217
kroB100.tsp,greedy-ls,greedy-cycle,N1,15,14204,10954,25158,21
kroB100.tsp,steepest-ls,greedy-cycle,N1,28,11205,15678,26883,36
kroA100.tsp,steepest-ls,random-walk,N2,63,14820,14781,29601,201
kroA100.tsp,greedy-ls,random-walk,N1,94,20217,27365,47582,184
kroA100.tsp,steepest-ls,random-walk,N1,3,17618,23398,41016,322
kroA100.tsp,greedy-ls,greedy-cycle,N1,17,14763,11657,26420,14
kroA100.tsp,steepest-ls,random-walk,N1,73,19178,23869,43047,304
kroB100.tsp,steepest-ls,greedy-cycle,N2,38,10838,15443,26281,44
kroA100.tsp,greedy-ls,random-walk,N2,84,14347,14590,28937,150
kroB100.tsp,greedy-ls,greedy-cycle,N1,81,11666,16493,28159,20
kroA100.tsp,steepest-ls,greedy-cycle,N2,75,15198,12386,27584,34
kroA100.tsp,greedy-ls,greedy-cycle,N1,83,11429,14959,26388,16
kroB100.tsp,greedy-ls,random-walk,N1,21,19208,19777,38985,165
kroB100.tsp,steepest-ls,random-walk,N2,63,16060,14416,30476,227
kroB100.tsp,steepest-ls,greedy-cycle,N1,53,10342,16742,27084,26
kroA100.tsp,steepest-ls,random-walk,N2,18,15622,13678,29300,222
kroA100.tsp,greedy-ls,random-walk,N1,100,22721,17336,40057,168
kroA100.tsp,greedy-ls,random-walk,N2,10,14798,13403,28201,159
kroA100.tsp,steepest-ls,random-walk,N2,100,13977,15126,29103,203
kroB100.tsp,greedy-ls,greedy-cycle,N2,91,11194,14616,25810,23
kroA100.tsp,steepest-ls,greedy-cycle,N1,65,15198,12386,27584,43
kroA100.tsp,greedy-ls,greedy-cycle,N2,93,11707,13870,25577,17
kroB100.tsp,steepest-ls,random-walk,N1,73,25222,22108,47330,334
kroB100.tsp,greedy-ls,random-walk,N2,31,14478,13916,28394,153
kroB100.tsp,steepest-ls,greedy-cycle,N2,43,12450,13601,26051,63
kroA100.tsp,steepest-ls,greedy-cycle,N2,22,15486,12386,27872,36
kroB100.tsp,greedy-ls,random-walk,N1,99,18404,21131,39535,178
kroA100.tsp,greedy-ls,random-walk,N1,57,17796,19404,37200,173
kroB100.tsp,greedy-ls,greedy-cycle,N1,39,10629,16742,27371,12
kroB100.tsp,greedy-ls,random-walk,N1,76,20801,17316,38117,188
kroB100.tsp,steepest-ls,random-walk,N2,34,15113,14769,29882,214
kroA100.tsp,steepest-ls,greedy-cycle,N1,32,14763,11657,26420,37
kroB100.tsp,greedy-ls,random-walk,N2,89,15492,13707,29199,163
kroB100.tsp,steepest-ls,random-walk,N2,4,14250,13899,28149,265
kroA100.tsp,greedy-ls,random-walk,N2,47,13151,14294,27445,169
kroA100.tsp,steepest-ls,random-walk,N2,6,13909,13962,27871,238
kroB100.tsp,steepest-ls,greedy-cycle,N2,14,14017,10353,24370,49
kroB100.tsp,steepest-ls,random-walk,N1,24,26509,21816,48325,305
kroB100.tsp,greedy-ls,random-walk,N2,66,13310,14619,27929,152
kroB100.tsp,greedy-ls,greedy-cycle,N2,29,11194,14657,25851,21
kroA100.tsp,greedy-ls,random-walk,N1,41,22539,18733,41272,198
kroA100.tsp,steepest-ls,greedy-cycle,N2,34,11713,14957,26670,49
kroB100.tsp,greedy-ls,random-walk,N1,60,18320,23310,41630,173
kroB100.tsp,steepest-ls,random-walk,N2,22,13931,14918,28849,230
kroA100.tsp,steepest-ls,random-walk,N2,59,14388,13759,28147,244
kroB100.tsp,steepest-ls,greedy-cycle,N1,12,11205,15678,26883,34
kroA100.tsp,greedy-ls,random-walk,N2,51,13220,15707,28927,171
kroA100.tsp,steepest-ls,greedy-cycle,N1,24,14595,11657,26252,27
kroB100.tsp,steepest-ls,random-walk,N1,32,19733,22953,42686,407
kroB100.tsp,greedy-ls,random-walk,N2,70,14470,14368,28838,151
kroA100.tsp,steepest-ls,random-walk,N1,49,27680,20122,47802,353
kroA100.tsp,steepest-ls,greedy-cycle,N2,63,13943,11657,25600,28
kroB100.tsp,greedy-ls,greedy-cycle,N1,97,11205,15678,26883,17
kroA100.tsp,greedy-ls,random-walk,N1,16,18141,19950,38091,194
kroB100.tsp,steepest-ls,greedy-cycle,N1,45,16692,10859,27551,38
kroB100.tsp,greedy-ls,greedy-cycle,N1,78,15361,11867,27228,19
kroB100.tsp,greedy-ls,random-walk,N1,37,16983,18494,35477,204
kroB100.tsp,steepest-ls,random-walk,N2,75,14556,13819,28375,239
kroA100.tsp,greedy-ls,greedy-cycle,N1,95,11657,14581,26238,23
kroA100.tsp,steepest-ls,greedy-cycle,N2,8,14813,12784,27597,30
kroA100.tsp,steepest-ls,greedy-cycle,N1,73,11600,14330,25930,54
kroB100.tsp,greedy-ls,greedy-cycle,N2,87,12632,13601,26233,25
kroB100.tsp,steepest-ls,greedy-cycle,N2,55,14968,11907,26875,35
kroB100.tsp,steepest-ls,random-walk,N1,65,20512,21681,42193,378
kroB100.tsp,greedy-ls,random-walk,N2,27,13556,13885,27441,175
kroB100.tsp,greedy-ls,greedy-cycle,N1,8,11194,15678,26872,16
kroB100.tsp,greedy-ls,greedy-cycle,N2,68,10829,16164,26993,23
kroA100.tsp,greedy-ls,greedy-cycle,N2,85,11600,13702,25302,24
kroA100.tsp,steepest-ls,greedy-cycle,N1,72,14581,11657,26238,28
kroA100.tsp,steepest-ls,greedy-cycle,N2,9,11713,14957,26670,44
kroB100.tsp,greedy-ls,greedy-cycle,N2,86,10268,15356,25624,25
kroB100.tsp,steepest-ls,greedy-cycle,N2,54,12420,14523,26943,37
kroB100.tsp,steepest-ls,random-walk,N1,64,20906,26526,47432,349
kroB100.tsp,greedy-ls,random-walk,N2,26,14607,14214,28821,159
kroB100.tsp,greedy-ls,greedy-cycle,N1,9,10827,16739,27566,8
kroB100.tsp,greedy-ls,greedy-cycle,N2,69,10342,15390,25732,22
kroA100.tsp,greedy-ls,greedy-cycle,N2,84,14435,11657,26092,13
kroA100.tsp,steepest-ls,greedy-cycle,N2,62,11876,15476,27352,38
kroB100.tsp,greedy-ls,greedy-cycle,N1,96,16148,11305,27453,16
kroA100.tsp,greedy-ls,random-walk,N1,17,19865,26448,46313,160
kroB100.tsp,steepest-ls,greedy-cycle,N1,44,15120,11444,26564,31
kroB100.tsp,greedy-ls,greedy-cycle,N1,79,11533,16624,28157,22
kroB100.tsp,greedy-ls,random-walk,N1,36,18384,18440,36824,211
kroB100.tsp,steepest-ls,random-walk,N2,74,13997,14878,28875,195
kroA100.tsp,greedy-ls,greedy-cycle,N2,1,12579,11039,23618,44
kroA100.tsp,greedy-ls,greedy-cycle,N1,94,15489,12386,27875,21
kroA100.tsp,greedy-ls,random-walk,N2,50,14191,13109,27300,161
kroA100.tsp,steepest-ls,greedy-cycle,N1,25,11698,16222,27920,37
kroB100.tsp,steepest-ls,random-walk,N1,33,21272,24175,45447,375
kroB100.tsp,greedy-ls,random-walk,N2,71,13136,15372,28508,161
kroA100.tsp,steepest-ls,random-walk,N1,48,22137,22393,44530,260
kroA100.tsp,greedy-ls,random-walk,N1,40,21851,20656,42507,188
kroA100.tsp,steepest-ls,greedy-cycle,N2,35,11713,14957,26670,47
kroB100.tsp,greedy-ls,random-walk,N1,61,20075,20213,40288,167
kroB100.tsp,steepest-ls,random-walk,N2,23,15626,12919,28545,245
kroA100.tsp,steepest-ls,random-walk,N2,58,13304,13600,26904,241
kroB100.tsp,steepest-ls,greedy-cycle,N1,13,15054,10577,25631,43
kroA100.tsp,steepest-ls,greedy-cycle,N1,33,11657,14581,26238,29
kroB100.tsp,greedy-ls,random-walk,N2,88,15099,14526,29625,136
kroA100.tsp,steepest-ls,greedy-cycle,N2,100,12386,15198,27584,37
kroB100.tsp,steepest-ls,random-walk,N2,5,15134,13442,28576,231
kroA100.tsp,greedy-ls,random-walk,N2,46,13961,12833,26794,160
kroA100.tsp,steepest-ls,random-walk,N2,7,13390,11916,25306,228
kroB100.tsp,steepest-ls,greedy-cycle,N2,15,14317,10353,24670,36
kroB100.tsp,steepest-ls,random-walk,N1,25,19637,20283,39920,278
kroB100.tsp,greedy-ls,random-walk,N2,67,14391,14804,29195,165
kroB100.tsp,greedy-ls,greedy-cycle,N2,28,11194,14664,25858,24
kroA100.tsp,steepest-ls,greedy-cycle,N2,23,14435,11657,26092,34
kroB100.tsp,greedy-ls,random-walk,N1,98,24091,18913,43004,188
kroA100.tsp,greedy-ls,random-walk,N1,56,24954,21802,46756,176
kroB100.tsp,greedy-ls,greedy-cycle,N1,38,11250,15302,26552,25
kroB100.tsp,greedy-ls,random-walk,N1,77,15985,21889,37874,195
kroB100.tsp,steepest-ls,random-walk,N2,35,13429,14934,28363,260
kroA100.tsp,greedy-ls,random-walk,N2,11,12097,13902,25999,167
kroB100.tsp,greedy-ls,greedy-cycle,N2,90,11658,14702,26360,19
kroA100.tsp,steepest-ls,greedy-cycle,N1,64,11600,14330,25930,62
kroA100.tsp,greedy-ls,greedy-cycle,N2,92,11860,10932,22792,35
kroB100.tsp,steepest-ls,random-walk,N1,72,19114,21894,41008,326
kroB100.tsp,greedy-ls,random-walk,N2,30,16089,14301,30390,159
kroB100.tsp,steepest-ls,greedy-cycle,N2,42,14317,10353,24670,34
kroB100.tsp,greedy-ls,greedy-cycle,N1,80,11250,15302,26552,26
kroA100.tsp,steepest-ls,greedy-cycle,N2,74,14147,11657,25804,37
kroA100.tsp,greedy-ls,greedy-cycle,N1,82,11657,14581,26238,14
kroB100.tsp,greedy-ls,random-walk,N1,20,18046,22146,40192,179
kroB100.tsp,steepest-ls,random-walk,N2,62,13438,15305,28743,231
kroB100.tsp,steepest-ls,greedy-cycle,N1,52,12635,14757,27392,43
kroA100.tsp,steepest-ls,random-walk,N2,19,13165,14826,27991,204
kroA100.tsp,steepest-ls,random-walk,N1,72,20039,20434,40473,296
kroB100.tsp,steepest-ls,greedy-cycle,N2,39,10153,16651,26804,19
kroA100.tsp,greedy-ls,random-walk,N2,85,15298,14962,30260,160
kroB100.tsp,steepest-ls,random-walk,N2,19,14176,13943,28119,249
kroB100.tsp,greedy-ls,greedy-cycle,N1,14,15011,11070,26081,20
kroB100.tsp,steepest-ls,greedy-cycle,N1,29,11205,15678,26883,32
kroA100.tsp,steepest-ls,random-walk,N2,62,13861,14262,28123,212
kroA100.tsp,greedy-ls,random-walk,N1,95,18842,16647,35489,170
kroA100.tsp,steepest-ls,random-walk,N1,2,21154,24271,45425,313
kroA100.tsp,greedy-ls,greedy-cycle,N1,16,15486,12386,27872,20
kroA100.tsp,steepest-ls,random-walk,N1,25,23767,23771,47538,243
kroB100.tsp,greedy-ls,greedy-cycle,N2,53,9963,16670,26633,13
kroA100.tsp,steepest-ls,greedy-cycle,N1,48,12386,15198,27584,43
kroA100.tsp,greedy-ls,greedy-cycle,N2,51,11551,13282,24833,30
kroB100.tsp,steepest-ls,greedy-cycle,N2,81,11505,16324,27829,42
kroA100.tsp,steepest-ls,random-walk,N2,35,14521,14911,29432,228
kroB100.tsp,greedy-ls,greedy-cycle,N1,43,12425,14472,26897,19
kroA100.tsp,greedy-ls,greedy-cycle,N1,41,12386,15198,27584,20
kroA100.tsp,steepest-ls,greedy-cycle,N2,58,11480,14136,25616,49
kroB100.tsp,steepest-ls,greedy-cycle,N1,91,11205,15678,26883,33
kroB100.tsp,greedy-ls,greedy-cycle,N2,45,16153,10859,27012,15
kroB100.tsp,steepest-ls,random-walk,N1,48,20255,21703,41958,260
kroB100.tsp,steepest-ls,greedy-cycle,N2,78,14384,11305,25689,37
kroA100.tsp,steepest-ls,random-walk,N1,33,22990,19094,42084,296
kroA100.tsp,greedy-ls,greedy-cycle,N1,4,15198,12386,27584,16
kroB100.tsp,steepest-ls,greedy-cycle,N2,97,11194,14354,25548,49
kroA100.tsp,greedy-ls,greedy-cycle,N2,47,14123,11657,25780,15
kroB100.tsp,steepest-ls,random-walk,N2,58,13486,14926,28412,265
kroB100.tsp,greedy-ls,greedy-cycle,N1,55,15350,11907,27257,16
kroA100.tsp,steepest-ls,random-walk,N2,23,14843,12153,26996,208
kroB100.tsp,steepest-ls,greedy-cycle,N1,68,11909,16449,28358,39
kroA100.tsp,greedy-ls,random-walk,N2,9,15499,12460,27959,153
kroB100.tsp,steepest-ls,greedy-cycle,N1,87,12450,13865,26315,56
kroA100.tsp,greedy-ls,greedy-cycle,N1,57,11669,16156,27825,19
kroA100.tsp,greedy-ls,random-walk,N2,93,15576,13864,29440,159
kroA100.tsp,steepest-ls,random-walk,N1,64,18845,24021,42866,301
kroB100.tsp,greedy-ls,greedy-cycle,N2,12,11194,14759,25953,19
kroA100.tsp,greedy-ls,greedy-cycle,N2,10,14178,11657,25835,17
kroB100.tsp,steepest-ls,greedy-cycle,N2,9,10827,15415,26242,33
kroA100.tsp,greedy-ls,random-walk,N1,83,20581,18673,39254,162
kroA100.tsp,steepest-ls,random-walk,N2,74,14291,15069,29360,214
kroA100.tsp,steepest-ls,greedy-cycle,N2,19,15198,12386,27584,38
kroB100.tsp,steepest-ls,random-walk,N2,97,13606,14129,27735,219
kroA100.tsp,greedy-ls,greedy-cycle,N1,77,11869,15727,27596,12
kroA100.tsp,greedy-ls,greedy-cycle,N1,98,14763,11657,26420,17
kroA100.tsp,steepest-ls,greedy-cycle,N2,81,11698,15245,26943,44
kroB100.tsp,steepest-ls,random-walk,N2,78,14243,14720,28963,236
kroB100.tsp,greedy-ls,greedy-cycle,N1,75,10840,15202,26042,31
kroB100.tsp,steepest-ls,greedy-cycle,N1,48,14408,10577,24985,56
kroB100.tsp,steepest-ls,random-walk,N1,87,19157,19782,38939,311
kroA100.tsp,steepest-ls,greedy-cycle,N2,5,11502,14424,25926,50
kroA100.tsp,greedy-ls,greedy-cycle,N2,67,13353,12498,25851,18
kroA100.tsp,steepest-ls,greedy-cycle,N1,91,14770,11657,26427,30
kroA100.tsp,greedy-ls,greedy-cycle,N2,88,15111,12386,27497,21
kroB100.tsp,greedy-ls,greedy-cycle,N1,5,10288,16742,27030,17
kroB100.tsp,greedy-ls,greedy-cycle,N2,65,11349,16306,27655,20
kroB100.tsp,steepest-ls,random-walk,N1,68,22892,19980,42872,319
kroB100.tsp,steepest-ls,greedy-cycle,N2,58,10837,15384,26221,45
kroA100.tsp,steepest-ls,random-walk,N1,13,22157,26889,49046,297
kroA100.tsp,steepest-ls,greedy-cycle,N2,39,12333,15083,27416,39
kroA100.tsp,greedy-ls,greedy-cycle,N1,20,11713,15934,27647,16
kroB100.tsp,greedy-ls,random-walk,N1,82,22152,24329,46481,170
kroA100.tsp,steepest-ls,random-walk,N2,54,14320,12837,27157,220
kroB100.tsp,greedy-ls,greedy-cycle,N1,22,15582,11907,27489,16
kroA100.tsp,greedy-ls,greedy-cycle,N2,30,12333,15086,27419,20
kroA100.tsp,steepest-ls,greedy-cycle,N1,29,12386,15198,27584,43
kroB100.tsp,greedy-ls,random-walk,N2,92,14581,14042,28623,160
kroA100.tsp,steepest-ls,random-walk,N1,44,23166,24027,47193,333
kroB100.tsp,greedy-ls,greedy-cycle,N2,32,11194,14759,25953,17
kroB100.tsp,greedy-ls,random-walk,N1,94,18479,18480,36959,164
kroA100.tsp,greedy-ls,greedy-cycle,N1,36,14581,11657,26238,16
kroB100.tsp,steepest-ls,random-walk,N2,39,13015,15235,28250,252
kroB100.tsp,greedy-ls,greedy-cycle,N1,34,10827,16739,27566,10
kroA100.tsp,steepest-ls,random-walk,N2,42,13225,13810,27035,219
kroB100.tsp,greedy-ls,random-walk,N2,7,14826,14102,28928,149
kroB100.tsp,steepest-ls,random-walk,N2,9,13526,14735,28261,222
kroB100.tsp,greedy-ls,random-walk,N2,84,13349,15069,28418,161
kroA100.tsp,greedy-ls,greedy-cycle,N2,26,15198,12386,27584,19
kroB100.tsp,greedy-ls,greedy-cycle,N2,24,14737,11867,26604,21
kroB100.tsp,steepest-ls,random-walk,N1,29,18733,23968,42701,336
kroA100.tsp,steepest-ls,random-walk,N1,52,18348,24586,42934,344
kroB100.tsp,steepest-ls,greedy-cycle,N2,19,14206,11305,25511,48
kroA100.tsp,greedy-ls,greedy-cycle,N1,61,11698,15934,27632,16
kroA100.tsp,steepest-ls,greedy-cycle,N2,78,11502,14424,25926,48
kroB100.tsp,steepest-ls,random-walk,N2,81,13261,13410,26671,260
kroA100.tsp,steepest-ls,random-walk,N2,15,14305,13493,27798,222
kroB100.tsp,greedy-ls,greedy-cycle,N1,63,13876,11011,24887,19
kroA100.tsp,steepest-ls,greedy-cycle,N2,97,15198,12386,27584,33
kroA100.tsp,steepest-ls,greedy-cycle,N1,68,11502,15434,26936,35
kroA100.tsp,greedy-ls,greedy-cycle,N2,71,12386,15198,27584,18
kroB100.tsp,steepest-ls,random-walk,N1,91,21723,20028,41751,343
kroB100.tsp,greedy-ls,greedy-cycle,N2,73,11108,13992,25100,19
kroA100.tsp,steepest-ls,greedy-cycle,N1,87,11698,15934,27632,37
kroA100.tsp,greedy-ls,random-walk,N1,99,26337,18106,44443,166
kroB100.tsp,steepest-ls,greedy-cycle,N1,25,10827,16739,27566,15
kroB100.tsp,greedy-ls,greedy-cycle,N1,18,15576,11305,26881,19
kroB100.tsp,greedy-ls,random-walk,N1,2,19659,21406,41065,174
kroB100.tsp,greedy-ls,random-walk,N1,57,20502,13557,34059,187
kroB100.tsp,steepest-ls,random-walk,N2,15,14810,14062,28872,265
kroA100.tsp,steepest-ls,random-walk,N2,81,13035,14927,27962,209
kroA100.tsp,greedy-ls,random-walk,N1,76,17070,21991,39061,210
kroA100.tsp,greedy-ls,random-walk,N2,89,14764,14119,28883,156
kroB100.tsp,steepest-ls,greedy-cycle,N2,35,10827,15415,26242,38
kroB100.tsp,greedy-ls,random-walk,N2,47,13880,14683,28563,154
kroA100.tsp,steepest-ls,greedy-cycle,N1,13,11657,14581,26238,30
kroA100.tsp,steepest-ls,random-walk,N1,91,23571,19201,42772,253
kroA100.tsp,greedy-ls,random-walk,N2,66,13263,13273,26536,154
kroB100.tsp,steepest-ls,random-walk,N2,42,15042,14675,29717,226
kroB100.tsp,steepest-ls,greedy-cycle,N1,72,11316,17195,28511,40
kroA100.tsp,steepest-ls,random-walk,N2,39,15328,14306,29634,241
kroA100.tsp,greedy-ls,random-walk,N1,21,18566,21703,40269,178
kroA100.tsp,steepest-ls,greedy-cycle,N2,54,11502,14991,26493,40
kroB100.tsp,steepest-ls,random-walk,N1,52,20395,17493,37888,316
kroB100.tsp,greedy-ls,random-walk,N2,10,14057,14899,28956,161
kroA100.tsp,steepest-ls,random-walk,N1,29,19635,21567,41202,363
kroB100.tsp,steepest-ls,greedy-cycle,N2,62,10344,13876,24220,53
kroA100.tsp,greedy-ls,random-walk,N2,31,14208,14280,28488,171
kroA100.tsp,steepest-ls,greedy-cycle,N1,44,11600,14330,25930,55
kroB100.tsp,steepest-ls,greedy-cycle,N1,64,14899,10763,25662,49
kroB100.tsp,greedy-ls,greedy-cycle,N1,59,11194,15678,26872,17
kroB100.tsp,greedy-ls,random-walk,N1,16,20128,20156,40284,155
kroB100.tsp,steepest-ls,random-walk,N2,54,14161,12920,27081,263
kroA100.tsp,steepest-ls,greedy-cycle,N2,42,11860,10969,22829,71
kroA100.tsp,greedy-ls,random-walk,N2,5,13330,13952,27282,188
kroA100.tsp,greedy-ls,random-walk,N1,37,20799,20963,41762,200
kroB100.tsp,steepest-ls,greedy-cycle,N2,74,12450,13601,26051,52
kroB100.tsp,steepest-ls,random-walk,N1,44,26363,21159,47522,345
kroB100.tsp,greedy-ls,greedy-cycle,N2,49,10838,15575,26413,20
kroA100.tsp,steepest-ls,greedy-cycle,N1,52,11502,15434,26936,41
kroA100.tsp,greedy-ls,random-walk,N2,27,16407,12986,29393,169
kroA100.tsp,greedy-ls,greedy-cycle,N1,8,14813,12784,27597,14
kroB100.tsp,greedy-ls,random-walk,N1,41,21542,18268,39810,154
kroA100.tsp,steepest-ls,random-walk,N2,78,14404,12826,27230,244
kroB100.tsp,steepest-ls,greedy-cycle,N1,33,14317,10763,25080,45
kroA100.tsp,greedy-ls,random-walk,N1,60,20821,21118,41939,157
kroA100.tsp,steepest-ls,random-walk,N2,97,14343,13791,28134,237
kroA100.tsp,steepest-ls,greedy-cycle,N2,15,14435,11657,26092,33
kroB100.tsp,steepest-ls,random-walk,N1,13,20946,23859,44805,254
kroB100.tsp,greedy-ls,random-walk,N2,51,14883,12581,27464,169
kroB100.tsp,steepest-ls,greedy-cycle,N2,23,14968,11907,26875,36
kroA100.tsp,steepest-ls,random-walk,N1,68,20842,19765,40607,365
kroB100.tsp,steepest-ls,greedy-cycle,N2,5,10099,16651,26750,19
kroA100.tsp,greedy-ls,random-walk,N2,70,12686,15940,28626,173
kroA100.tsp,steepest-ls,random-walk,N1,87,21093,25269,46362,304
kroA100.tsp,steepest-ls,greedy-cycle,N2,82,11657,14435,26092,29
kroB100.tsp,greedy-ls,random-walk,N1,39,17757,18775,36532,179
kroB100.tsp,greedy-ls,greedy-cycle,N1,76,11194,15678,26872,14
kroB100.tsp,steepest-ls,random-walk,N2,94,14384,13451,27835,208
kroB100.tsp,greedy-ls,greedy-cycle,N1,99,11194,15678,26872,20
kroA100.tsp,greedy-ls,greedy-cycle,N1,74,14595,11657,26252,15
kroA100.tsp,greedy-ls,random-walk,N1,18,20329,22008,42337,194
kroA100.tsp,steepest-ls,random-walk,N1,10,17353,20896,38249,294
kroA100.tsp,steepest-ls,greedy-cycle,N1,92,11860,11668,23528,72
kroA100.tsp,greedy-ls,random-walk,N1,3,19338,24746,44084,189
kroB100.tsp,greedy-ls,greedy-cycle,N2,66,12338,13959,26297,25
kroB100.tsp,greedy-ls,greedy-cycle,N1,6,13672,10458,24130,22
kroB100.tsp,greedy-ls,random-walk,N2,29,14537,12942,27479,157
kroB100.tsp,greedy-ls,greedy-cycle,N2,89,12404,14208,26612,24
kroB100.tsp,steepest-ls,random-walk,N1,84,21868,21550,43418,270
kroA100.tsp,greedy-ls,greedy-cycle,N2,64,11502,15216,26718,21
kroA100.tsp,steepest-ls,greedy-cycle,N2,6,15513,12386,27899,27
kroB100.tsp,steepest-ls,greedy-cycle,N1,3,11119,15138,26257,28
kroB100.tsp,greedy-ls,greedy-cycle,N1,21,12191,16227,28418,21
kroA100.tsp,steepest-ls,random-walk,N2,57,12258,15322,27580,208
kroA100.tsp,greedy-ls,greedy-cycle,N1,23,14630,11657,26287,19
kroB100.tsp,greedy-ls,random-walk,N1,81,17428,18191,35619,195
kroB100.tsp,greedy-ls,greedy-cycle,N2,31,14204,11351,25555,17
kroA100.tsp,steepest-ls,random-walk,N1,47,21851,20194,42045,263
kroA100.tsp,greedy-ls,greedy-cycle,N2,33,11657,14435,26092,15
kroB100.tsp,greedy-ls,random-walk,N2,91,14543,15511,30054,161
kroA100.tsp,steepest-ls,random-walk,N2,41,13361,12343,25704,250
kroB100.tsp,greedy-ls,random-walk,N1,78,20775,21962,42737,161
kroB100.tsp,greedy-ls,greedy-cycle,N1,37,11339,17060,28399,18
kroB100.tsp,greedy-ls,random-walk,N1,97,21899,19058,40957,174
kroA100.tsp,greedy-ls,greedy-cycle,N1,35,11713,15934,27647,20
kroA100.tsp,greedy-ls,random-walk,N1,59,18813,19931,38744,162
kroA100.tsp,steepest-ls,random-walk,N1,51,23716,18949,42665,305
kroA100.tsp,steepest-ls,random-walk,N2,8,12901,14469,27370,231
kroB100.tsp,greedy-ls,greedy-cycle,N2,27,10827,15593,26420,17
kroB100.tsp,greedy-ls,random-walk,N2,68,12412,17842,30254,159
kroB100.tsp,greedy-ls,random-walk,N2,87,12832,13751,26583,181
kroA100.tsp,greedy-ls,greedy-cycle,N2,25,11654,15706,27360,19
kroB100.tsp,greedy-ls,random-walk,N2,4,13307,15998,29305,171
kroA100.tsp,greedy-ls,random-walk,N2,49,14785,12591,27376,150
kroB100.tsp,greedy-ls,greedy-cycle,N1,60,12428,14532,26960,26
kroA100.tsp,steepest-ls,greedy-cycle,N2,94,15486,12386,27872,35
kroA100.tsp,steepest-ls,random-walk,N2,16,13738,14111,27849,240
kroA100.tsp,greedy-ls,greedy-cycle,N1,62,11823,15728,27551,15
kroB100.tsp,steepest-ls,random-walk,N2,82,13666,14536,28202,204
kroB100.tsp,greedy-ls,greedy-cycle,N2,70,9963,16670,26633,14
kroA100.tsp,steepest-ls,greedy-cycle,N1,84,14581,11657,26238,30
kroA100.tsp,greedy-ls,greedy-cycle,N2,72,14435,11657,26092,14
kroB100.tsp,steepest-ls,random-walk,N1,92,22607,22109,44716,312
kroA100.tsp,steepest-ls,random-walk,N2,82,13731,13575,27306,241
kroA100.tsp,greedy-ls,random-walk,N1,75,20398,17963,38361,178
kroA100.tsp,greedy-ls,greedy-cycle,N1,19,15198,12386,27584,23
kroB100.tsp,greedy-ls,random-walk,N1,1,26132,21468,47600,149
kroB100.tsp,steepest-ls,random-walk,N2,16,15154,14278,29432,215
kroB100.tsp,greedy-ls,random-walk,N1,54,23261,18885,42146,193
kroB100.tsp,steepest-ls,greedy-cycle,N1,26,10730,14227,24957,56
kroA100.tsp,steepest-ls,random-walk,N1,92,19534,18830,38364,324
kroA100.tsp,greedy-ls,random-walk,N2,65,14887,15019,29906,154
kroA100.tsp,steepest-ls,greedy-cycle,N1,10,14595,11657,26252,29
kroB100.tsp,greedy-ls,random-walk,N2,44,14401,13340,27741,168
kroB100.tsp,steepest-ls,greedy-cycle,N2,36,14882,10859,25741,52
kroA100.tsp,steepest-ls,greedy-cycle,N2,57,11713,14957,26670,45
kroA100.tsp,greedy-ls,random-walk,N1,22,25027,17723,42750,188
kroB100.tsp,steepest-ls,greedy-cycle,N1,71,11205,15678,26883,35
kroB100.tsp,steepest-ls,random-walk,N2,41,12351,15290,27641,224
kroA100.tsp,steepest-ls,greedy-cycle,N1,47,14995,11657,26652,27
kroA100.tsp,greedy-ls,random-walk,N2,32,14551,12983,27534,165
kroB100.tsp,steepest-ls,greedy-cycle,N2,61,10827,15415,26242,33
kroB100.tsp,greedy-ls,random-walk,N2,13,16665,14114,30779,148
kroB100.tsp,steepest-ls,random-walk,N1,51,21250,20294,41544,269
kroB100.tsp,steepest-ls,greedy-cycle,N1,88,15347,11907,27254,39
kroA100.tsp,greedy-ls,random-walk,N2,6,14964,13282,28246,167
kroA100.tsp,greedy-ls,random-walk,N1,34,22199,20560,42759,161
kroB100.tsp,greedy-ls,greedy-cycle,N2,3,11108,14113,25221,16
kroA100.tsp,greedy-ls,greedy-cycle,N1,58,11674,16156,27830,20
kroA100.tsp,steepest-ls,greedy-cycle,N2,41,12386,15198,27584,36
kroB100.tsp,steepest-ls,random-walk,N2,57,13425,13018,26443,251
kroB100.tsp,greedy-ls,random-walk,N1,15,17111,20007,37118,182
kroB100.tsp,steepest-ls,greedy-cycle,N1,67,10288,16742,27030,25
kroA100.tsp,steepest-ls,greedy-cycle,N1,3,12386,15198,27584,38
kroB100.tsp,steepest-ls,greedy-cycle,N2,98,11194,14354,25548,49
kroA100.tsp,greedy-ls,random-walk,N2,24,14068,13912,27980,153
kroA100.tsp,steepest-ls,greedy-cycle,N1,51,11698,15934,27632,35
kroA100.tsp,greedy-ls,greedy-cycle,N2,48,12386,15198,27584,19
kroB100.tsp,steepest-ls,random-walk,N1,47,18709,19621,38330,339
kroB100.tsp,steepest-ls,greedy-cycle,N2,77,14384,11305,25689,36
kroA100.tsp,steepest-ls,greedy-cycle,N2,16,15486,12386,27872,36
kroA100.tsp,greedy-ls,random-walk,N1,63,22909,18346,41255,177
kroA100.tsp,steepest-ls,random-walk,N2,94,13964,12748,26712,239
kroB100.tsp,steepest-ls,greedy-cycle,N1,30,11027,15534,26561,62
kroB100.tsp,greedy-ls,random-walk,N1,42,22017,16439,38456,175
kroB100.tsp,steepest-ls,greedy-cycle,N2,6,14317,10353,24670,41
kroA100.tsp,greedy-ls,random-walk,N2,73,14618,13375,27993,155
kroA100.tsp,steepest-ls,random-walk,N1,84,18570,19351,37921,372
kroB100.tsp,steepest-ls,greedy-cycle,N2,20,10838,15443,26281,47
kroB100.tsp,greedy-ls,random-walk,N2,52,14760,15014,29774,163
kroB100.tsp,steepest-ls,random-walk,N1,10,20702,20338,41040,302
kroB100.tsp,greedy-ls,random-walk,N2,25,15326,14189,29515,153
kroB100.tsp,steepest-ls,random-walk,N1,67,23031,21615,44646,327
kroA100.tsp,greedy-ls,greedy-cycle,N2,87,11697,13477,25174,25
kroB100.tsp,steepest-ls,greedy-cycle,N2,57,10827,15415,26242,33
kroA100.tsp,steepest-ls,greedy-cycle,N1,71,12386,15198,27584,43
kroA100.tsp,greedy-ls,greedy-cycle,N2,68,11502,15010,26512,17
kroB100.tsp,steepest-ls,random-walk,N1,88,23305,19383,42688,303
kroB100.tsp,greedy-ls,greedy-cycle,N2,85,11108,13946,25054,25
kroB100.tsp,steepest-ls,random-walk,N2,77,14444,13834,28278,227
kroB100.tsp,greedy-ls,random-walk,N1,35,16257,25338,41595,201
kroA100.tsp,greedy-ls,greedy-cycle,N2,2,11502,14991,26493,14
kroA100.tsp,greedy-ls,greedy-cycle,N1,97,15198,12386,27584,15
kroB100.tsp,steepest-ls,greedy-cycle,N1,47,11219,16084,27303,53
kroA100.tsp,greedy-ls,random-walk,N1,14,19452,18347,37799,186
kroA100.tsp,greedy-ls,greedy-cycle,N1,78,12064,13527,25591,26
kroA100.tsp,steepest-ls,greedy-cycle,N2,61,11698,14957,26655,45
kroB100.tsp,greedy-ls,greedy-cycle,N1,95,11984,14883,26867,31
kroB100.tsp,steepest-ls,random-walk,N2,98,14298,15960,30258,251
kroB100.tsp,greedy-ls,random-walk,N2,72,16738,14762,31500,149
kroB100.tsp,steepest-ls,random-walk,N1,30,18881,19565,38446,297
kroA100.tsp,steepest-ls,greedy-cycle,N1,26,15198,12386,27584,41
kroA100.tsp,greedy-ls,random-walk,N2,53,14961,13561,28522,148
kroB100.tsp,steepest-ls,greedy-cycle,N1,10,11909,16449,28358,37
kroB100.tsp,steepest-ls,random-walk,N2,20,13137,14696,27833,217
kroB100.tsp,greedy-ls,random-walk,N1,62,17975,19175,37150,174
kroA100.tsp,steepest-ls,greedy-cycle,N2,36,14435,11657,26092,25
kroA100.tsp,greedy-ls,random-walk,N1,43,16200,21865,38065,179
kroB100.tsp,greedy-ls,random-walk,N2,64,15611,14283,29894,157
kroB100.tsp,steepest-ls,random-walk,N1,26,16924,20667,37591,390
kroA100.tsp,steepest-ls,random-walk,N2,4,12429,13757,26186,218
kroB100.tsp,steepest-ls,greedy-cycle,N2,16,14384,11305,25689,37
kroB100.tsp,steepest-ls,random-walk,N2,6,14858,14242,29100,241
kroA100.tsp,greedy-ls,random-walk,N2,45,13507,13016,26523,156
kroB100.tsp,greedy-ls,random-walk,N2,8,13843,13831,27674,139
kroA100.tsp,greedy-ls,greedy-cycle,N2,29,12386,15198,27584,14
kroA100.tsp,steepest-ls,greedy-cycle,N1,30,12333,15083,27416,41
kroB100.tsp,steepest-ls,random-walk,N2,36,15081,14518,29599,229
kroB100.tsp,greedy-ls,random-walk,N1,74,22423,20614,43037,202
kroA100.tsp,greedy-ls,random-walk,N1,55,20013,21024,41037,193
kroA100.tsp,steepest-ls,greedy-cycle,N2,20,11713,14957,26670,44
kroA100.tsp,greedy-ls,greedy-cycle,N1,39,12333,15086,27419,20
kroB100.tsp,steepest-ls,greedy-cycle,N2,41,14882,10859,25741,51
kroA100.tsp,steepest-ls,greedy-cycle,N1,88,15486,12386,27872,41
kroA100.tsp,greedy-ls,greedy-cycle,N2,91,14435,11657,26092,13
kroB100.tsp,greedy-ls,random-walk,N2,33,15454,14123,29577,159
kroB100.tsp,steepest-ls,random-walk,N1,71,25834,22546,48380,290
kroB100.tsp,greedy-ls,greedy-cycle,N2,93,11108,13985,25093,20
kroA100.tsp,steepest-ls,greedy-cycle,N1,67,13148,12828,25976,43
kroA100.tsp,greedy-ls,random-walk,N2,12,13877,15885,29762,160
kroB100.tsp,steepest-ls,greedy-cycle,N1,51,14408,10763,25171,55
kroA100.tsp,greedy-ls,greedy-cycle,N1,81,11654,16484,28138,20
kroA100.tsp,steepest-ls,greedy-cycle,N2,98,14428,11657,26085,33
kroB100.tsp,steepest-ls,random-walk,N2,61,15757,13171,28928,208
kroB100.tsp,greedy-ls,random-walk,N1,23,18751,18677,37428,169
kroB100.tsp,greedy-ls,greedy-cycle,N1,83,14317,10763,25080,17
kroA100.tsp,steepest-ls,greedy-cycle,N2,77,11876,15476,27352,29
kroB100.tsp,greedy-ls,random-walk,N1,100,20487,18507,38994,176
kroA100.tsp,greedy-ls,random-walk,N2,69,13356,15098,28454,145
kroA100.tsp,steepest-ls,random-walk,N1,71,22748,17125,39873,346
kroA100.tsp,greedy-ls,random-walk,N2,86,12987,14062,27049,164
kroB100.tsp,greedy-ls,random-walk,N2,48,12635,14643,27278,163
kroA100.tsp,steepest-ls,random-walk,N1,1,21154,24271,45425,296
kroA100.tsp,greedy-ls,greedy-cycle,N1,15,14630,11657,26287,16
kroA100.tsp,greedy-ls,random-walk,N1,79,22361,18141,40502,189
kroA100.tsp,steepest-ls,random-walk,N2,61,13954,13343,27297,245
kroA100.tsp,greedy-ls,random-walk,N1,96,22378,18892,41270,174
kroB100.tsp,steepest-ls,random-walk,N1,3,24474,20024,44498,325
kroB100.tsp,greedy-ls,random-walk,N1,58,22773,15667,38440,154
kroB100.tsp,greedy-ls,greedy-cycle,N1,17,16692,10859,27551,21
kroB100.tsp,steepest-ls,greedy-cycle,N2,82,14017,10353,24370,49
kroA100.tsp,greedy-ls,greedy-cycle,N2,52,11502,14759,26261,18
kroB100.tsp,greedy-ls,greedy-cycle,N2,50,15240,11807,27047,17
kroA100.tsp,steepest-ls,random-walk,N1,26,23366,15452,38818,370
kroB100.tsp,steepest-ls,greedy-cycle,N1,92,15985,11305,27290,38
kroA100.tsp,greedy-ls,greedy-cycle,N1,42,13485,12074,25559,21
kroB100.tsp,greedy-ls,greedy-cycle,N1,40,10342,16629,26971,12
kroA100.tsp,steepest-ls,random-walk,N2,36,14814,14546,29360,223
kroA100.tsp,greedy-ls,greedy-cycle,N2,44,11696,16215,27911,17
kroA100.tsp,greedy-ls,greedy-cycle,N1,7,11674,13758,25432,28
kroA100.tsp,greedy-ls,random-walk,N2,28,14722,13631,28353,157
kroB100.tsp,steepest-ls,greedy-cycle,N2,94,10827,15415,26242,34
kroA100.tsp,steepest-ls,random-walk,N1,30,18183,19831,38014,361
kroB100.tsp,greedy-ls,greedy-cycle,N2,46,10827,15684,26511,14
kroA100.tsp,greedy-ls,greedy-cycle,N1,54,11600,14330,25930,33
kroA100.tsp,greedy-ls,random-walk,N1,38,15674,22121,37795,195
kroB100.tsp,steepest-ls,greedy-cycle,N1,84,10826,16765,27591,22
kroA100.tsp,steepest-ls,random-walk,N2,20,13025,13959,26984,232
kroB100.tsp,greedy-ls,random-walk,N1,19,18894,17929,36823,172
kroB100.tsp,greedy-ls,greedy-cycle,N1,56,11062,14191,25253,20
kroA100.tsp,steepest-ls,random-walk,N1,88,22987,21538,44525,279
kroA100.tsp,greedy-ls,greedy-cycle,N2,13,11657,14435,26092,13
kroB100.tsp,greedy-ls,greedy-cycle,N2,11,11108,14219,25327,17
kroA100.tsp,greedy-ls,random-walk,N2,90,13788,14147,27935,159
kroA100.tsp,steepest-ls,random-walk,N1,67,22642,20470,43112,280
kroA100.tsp,steepest-ls,random-walk,N2,98,14481,15312,29793,218
kroA100.tsp,greedy-ls,random-walk,N1,80,19763,19188,38951,220
kroA100.tsp,steepest-ls,random-walk,N2,77,14248,13956,28204,228
kroA100.tsp,steepest-ls,random-walk,N2,99,13524,12642,26166,256
kroA100.tsp,greedy-ls,random-walk,N1,81,19042,22974,42016,168
kroA100.tsp,steepest-ls,random-walk,N2,76,12112,14123,26235,234
kroA100.tsp,steepest-ls,random-walk,N1,89,21587,21810,43397,336
kroA100.tsp,greedy-ls,greedy-cycle,N2,12,11713,14957,26670,19
kroB100.tsp,greedy-ls,greedy-cycle,N2,10,10276,14948,25224,36
kroA100.tsp,greedy-ls,random-walk,N2,91,14909,14413,29322,174
kroA100.tsp,steepest-ls,random-walk,N1,66,20641,19087,39728,333
kroA100.tsp,greedy-ls,greedy-cycle,N1,55,12948,12626,25574,59
kroA100.tsp,greedy-ls,random-walk,N1,39,23498,19130,42628,157
kroB100.tsp,steepest-ls,greedy-cycle,N1,85,11119,15138,26257,30
kroA100.tsp,steepest-ls,random-walk,N2,21,13246,13219,26465,246
kroB100.tsp,greedy-ls,random-walk,N1,18,17599,24796,42395,151
kroB100.tsp,greedy-ls,greedy-cycle,N1,57,10827,16739,27566,9
kroA100.tsp,greedy-ls,greedy-cycle,N2,45,14435,11657,26092,15
kroA100.tsp,greedy-ls,greedy-cycle,N1,6,15513,12386,27899,17
kroA100.tsp,greedy-ls,random-walk,N2,29,12980,12577,25557,164
kroB100.tsp,steepest-ls,greedy-cycle,N2,95,11506,14572,26078,50
kroA100.tsp,steepest-ls,random-walk,N1,31,24240,20216,44456,287
kroB100.tsp,greedy-ls,greedy-cycle,N2,47,11014,16353,27367,25
kroB100.tsp,steepest-ls,greedy-cycle,N1,93,11119,15138,26257,29
kroA100.tsp,greedy-ls,greedy-cycle,N1,43,12386,15198,27584,23
kroB100.tsp,greedy-ls,greedy-cycle,N1,41,16619,10859,27478,18
kroA100.tsp,steepest-ls,random-walk,N2,37,14474,14965,29439,216
kroB100.tsp,steepest-ls,greedy-cycle,N2,83,14317,10353,24670,36
kroA100.tsp,greedy-ls,greedy-cycle,N2,53,15489,12386,27875,16
kroB100.tsp,greedy-ls,greedy-cycle,N2,51,13917,10370,24287,29
kroA100.tsp,steepest-ls,random-walk,N1,27,21290,27852,49142,282
kroB100.tsp,greedy-ls,greedy-cycle,N1,100,11062,14078,25140,23
kroA100.tsp,greedy-ls,greedy-cycle,N1,14,12386,15198,27584,20
kroA100.tsp,greedy-ls,random-walk,N1,78,19718,19740,39458,183
kroA100.tsp,steepest-ls,random-walk,N2,60,15388,13404,28792,201
kroA100.tsp,greedy-ls,random-walk,N1,97,21678,20378,42056,209
kroB100.tsp,steepest-ls,random-walk,N1,2,22653,23877,46530,434
kroB100.tsp,greedy-ls,random-walk,N1,59,21786,17946,39732,168
kroB100.tsp,greedy-ls,greedy-cycle,N1,16,15576,11305,26881,12
kroA100.tsp,greedy-ls,random-walk,N2,68,14915,13324,28239,172
kroA100.tsp,steepest-ls,random-walk,N1,70,20122,20354,40476,345
kroA100.tsp,greedy-ls,random-walk,N2,87,13242,14433,27675,167
kroB100.tsp,greedy-ls,random-walk,N2,49,13682,14809,28491,160
kroB100.tsp,steepest-ls,greedy-cycle,N1,50,15384,11807,27191,41
kroA100.tsp,steepest-ls,greedy-cycle,N2,99,14435,11657,26092,29
kroA100.tsp,greedy-ls,greedy-cycle,N1,80,11860,11668,23528,32
kroB100.tsp,steepest-ls,random-walk,N2,60,13504,15563,29067,207
kroB100.tsp,greedy-ls,random-walk,N1,22,19244,18673,37917,164
kroB100.tsp,greedy-ls,greedy-cycle,N1,82,14899,10617,25516,16
kroA100.tsp,steepest-ls,greedy-cycle,N2,76,11657,14435,26092,29
kroA100.tsp,greedy-ls,greedy-cycle,N1,100,12386,15198,27584,16
kroB100.tsp,steepest-ls,greedy-cycle,N2,40,10153,16651,26804,20
kroA100.tsp,greedy-ls,greedy-cycle,N2,90,15513,12386,27899,12
kroA100.tsp,steepest-ls,greedy-cycle,N1,89,11860,11668,23528,63
kroB100.tsp,greedy-ls,random-walk,N2,32,14051,13738,27789,139
kroB100.tsp,steepest-ls,random-walk,N1,70,23031,21629,44660,316
kroB100.tsp,greedy-ls,greedy-cycle,N2,92,14042,11222,25264,27
kroA100.tsp,steepest-ls,greedy-cycle,N1,66,15198,12386,27584,41
kroA100.tsp,greedy-ls,random-walk,N2,13,14833,12990,27823,160
kroB100.tsp,steepest-ls,random-walk,N2,37,14275,13965,28240,223
kroB100.tsp,greedy-ls,random-walk,N1,75,22233,19543,41776,180
kroA100.tsp,greedy-ls,random-walk,N1,54,22957,16854,39811,209
kroA100.tsp,greedy-ls,greedy-cycle,N1,38,14581,11657,26238,15
kroA100.tsp,steepest-ls,greedy-cycle,N2,21,14435,11657,26092,27
kroB100.tsp,greedy-ls,random-walk,N2,65,13193,15194,28387,160
kroB100.tsp,steepest-ls,random-walk,N1,27,21045,20085,41130,295
kroA100.tsp,steepest-ls,random-walk,N2,5,14291,12733,27024,208
kroB100.tsp,steepest-ls,greedy-cycle,N2,17,14882,10859,25741,53
kroB100.tsp,steepest-ls,random-walk,N2,7,13265,15100,28365,253
kroA100.tsp,greedy-ls,random-walk,N2,44,13362,14459,27821,169
kroB100.tsp,greedy-ls,random-walk,N2,9,15559,13105,28664,152
kroA100.tsp,steepest-ls,greedy-cycle,N1,31,11860,11668,23528,63
kroA100.tsp,greedy-ls,greedy-cycle,N2,28,13148,12708,25856,17
kroB100.tsp,steepest-ls,greedy-cycle,N1,11,11119,15138,26257,25
kroB100.tsp,steepest-ls,random-walk,N2,21,15624,14161,29785,205
kroB100.tsp,greedy-ls,random-walk,N1,63,19188,19337,38525,201
kroA100.tsp,steepest-ls,greedy-cycle,N2,37,11502,14424,25926,48
kroA100.tsp,greedy-ls,random-walk,N1,42,18766,19769,38535,177
kroB100.tsp,greedy-ls,random-walk,N2,73,13842,14141,27983,162
kroB100.tsp,steepest-ls,random-walk,N1,31,18455,20713,39168,265
kroA100.tsp,steepest-ls,greedy-cycle,N1,27,11713,15934,27647,36
kroA100.tsp,greedy-ls,random-walk,N2,52,14102,13052,27154,173
kroA100.tsp,greedy-ls,greedy-cycle,N2,3,12386,15198,27584,14
kroB100.tsp,steepest-ls,random-walk,N2,76,13639,14899,28538,216
kroB100.tsp,greedy-ls,random-walk,N1,34,20211,18629,38840,182
kroA100.tsp,greedy-ls,greedy-cycle,N1,96,11502,15437,26939,27
kroB100.tsp,steepest-ls,greedy-cycle,N1,46,10827,16739,27566,19
kroA100.tsp,greedy-ls,random-walk,N1,15,18358,19720,38078,191
kroA100.tsp,steepest-ls,greedy-cycle,N2,60,11876,15476,27352,30
kroA100.tsp,greedy-ls,greedy-cycle,N1,79,15489,12386,27875,26
kroB100.tsp,greedy-ls,greedy-cycle,N1,94,10827,16739,27566,13
kroB100.tsp,steepest-ls,random-walk,N2,99,13870,15042,28912,242
kroB100.tsp,greedy-ls,random-walk,N2,24,12920,15393,28313,151
kroB100.tsp,steepest-ls,random-walk,N1,66,22812,19921,42733,354
kroA100.tsp,greedy-ls,greedy-cycle,N2,86,11713,15281,26994,18
kroB100.tsp,steepest-ls,greedy-cycle,N2,56,10344,13876,24220,53
kroA100.tsp,greedy-ls,greedy-cycle,N2,69,12180,14153,26333,32
kroA100.tsp,steepest-ls,greedy-cycle,N1,70,15486,12386,27872,38
kroB100.tsp,steepest-ls,random-walk,N1,89,15110,21694,36804,322
kroB100.tsp,greedy-ls,greedy-cycle,N2,84,10837,15694,26531,17
kroA100.tsp,greedy-ls,random-walk,N2,72,12476,14491,26967,170
kroB100.tsp,steepest-ls,greedy-cycle,N2,7,10837,15384,26221,41
kroA100.tsp,steepest-ls,random-walk,N1,85,19155,19624,38779,323
kroB100.tsp,steepest-ls,greedy-cycle,N2,21,11506,14572,26078,49
kroB100.tsp,greedy-ls,random-walk,N2,53,13488,13999,27487,162
kroB100.tsp,steepest-ls,random-walk,N1,11,26104,21468,47572,252
kroA100.tsp,steepest-ls,greedy-cycle,N2,17,14428,11657,26085,32
kroA100.tsp,greedy-ls,random-walk,N1,62,22436,21112,43548,158
kroA100.tsp,steepest-ls,random-walk,N2,95,14228,14160,28388,226
kroB100.tsp,steepest-ls,greedy-cycle,N1,31,14408,10577,24985,52
kroB100.tsp,greedy-ls,random-walk,N1,43,16040,21691,37731,209
kroB100.tsp,steepest-ls,greedy-cycle,N2,99,11194,14354,25548,52
kroA100.tsp,greedy-ls,random-walk,N2,25,14305,12773,27078,162
kroA100.tsp,greedy-ls,greedy-cycle,N2,49,15513,12386,27899,13
kroA100.tsp,steepest-ls,greedy-cycle,N1,50,11600,14330,25930,53
kroB100.tsp,steepest-ls,random-walk,N1,46,23809,19733,43542,345
kroB100.tsp,steepest-ls,greedy-cycle,N2,76,11194,14354,25548,48
kroA100.tsp,greedy-ls,random-walk,N2,7,13132,13029,26161,169
kroB100.tsp,steepest-ls,greedy-cycle,N1,89,12450,13865,26315,58
kroB100.tsp,greedy-ls,greedy-cycle,N2,2,13876,10048,23924,25
kroA100.tsp,greedy-ls,random-walk,N1,35,17308,21842,39150,195
kroA100.tsp,steepest-ls,greedy-cycle,N2,40,11502,14991,26493,49
kroA100.tsp,greedy-ls,greedy-cycle,N1,59,14595,11657,26252,15
kroB100.tsp,steepest-ls,random-walk,N2,56,14037,14323,28360,227
kroB100.tsp,greedy-ls,random-walk,N1,14,18418,23494,41912,159
kroB100.tsp,steepest-ls,greedy-cycle,N1,66,12376,13854,26230,64
kroA100.tsp,steepest-ls,greedy-cycle,N1,2,11600,14330,25930,53
kroA100.tsp,steepest-ls,greedy-cycle,N1,46,12386,15198,27584,42
kroA100.tsp,greedy-ls,random-walk,N2,33,15347,13501,28848,161
kroB100.tsp,steepest-ls,greedy-cycle,N2,60,12450,13601,26051,54
kroB100.tsp,greedy-ls,random-walk,N2,12,14709,14795,29504,154
kroB100.tsp,steepest-ls,random-walk,N1,50,22218,23148,45366,275
kroA100.tsp,steepest-ls,greedy-cycle,N2,56,15198,12386,27584,32
kroA100.tsp,greedy-ls,random-walk,N1,23,22581,17905,40486,183
kroB100.tsp,steepest-ls,greedy-cycle,N1,70,10342,16742,27084,25
kroB100.tsp,steepest-ls,random-walk,N2,40,14373,14488,28861,231
kroA100.tsp,steepest-ls,random-walk,N1,93,19182,22579,41761,304
kroA100.tsp,greedy-ls,random-walk,N2,64,14974,13453,28427,151
kroA100.tsp,steepest-ls,greedy-cycle,N1,11,14770,11657,26427,30
kroB100.tsp,greedy-ls,random-walk,N2,45,13440,14490,27930,155
kroB100.tsp,steepest-ls,greedy-cycle,N2,37,10628,17104,27732,31
kroA100.tsp,steepest-ls,random-walk,N2,83,12556,14231,26787,218
kroA100.tsp,greedy-ls,random-walk,N1,74,23302,19101,42403,201
kroA100.tsp,greedy-ls,greedy-cycle,N1,18,14595,11657,26252,14
kroB100.tsp,steepest-ls,random-walk,N2,17,13133,14907,28040,267
kroB100.tsp,greedy-ls,random-walk,N1,55,15697,22162,37859,183
kroB100.tsp,steepest-ls,greedy-cycle,N1,27,10827,16739,27566,15
kroB100.tsp,greedy-ls,greedy-cycle,N2,71,11194,14581,25775,20
kroA100.tsp,steepest-ls,greedy-cycle,N1,85,11502,15434,26936,38
kroA100.tsp,greedy-ls,greedy-cycle,N2,73,11502,15216,26718,19
kroB100.tsp,steepest-ls,random-walk,N1,93,23981,19666,43647,370
kroB100.tsp,greedy-ls,greedy-cycle,N1,61,10827,16739,27566,8
kroA100.tsp,steepest-ls,greedy-cycle,N2,95,11657,14435,26092,27
kroA100.tsp,steepest-ls,random-walk,N2,17,12854,13507,26361,264
kroA100.tsp,greedy-ls,greedy-cycle,N1,63,14698,11657,26355,12
kroB100.tsp,steepest-ls,random-walk,N2,83,14457,14423,28880,217
kroA100.tsp,steepest-ls,random-walk,N1,50,21661,23724,45385,297
kroA100.tsp,steepest-ls,random-walk,N2,9,14019,13321,27340,207
kroB100.tsp,greedy-ls,greedy-cycle,N2,26,10342,15390,25732,30
kroB100.tsp,greedy-ls,random-walk,N2,69,12701,13724,26425,173
kroB100.tsp,greedy-ls,random-walk,N2,86,13990,13054,27044,172
kroA100.tsp,greedy-ls,greedy-cycle,N2,24,14157,11657,25814,22
kroB100.tsp,greedy-ls,random-walk,N2,5,13688,15792,29480,177
kroA100.tsp,greedy-ls,random-walk,N2,48,14372,13279,27651,156
kroA100.tsp,steepest-ls,random-walk,N2,40,14235,13306,27541,221
kroB100.tsp,greedy-ls,random-walk,N1,79,20331,20985,41316,173
kroB100.tsp,greedy-ls,greedy-cycle,N1,36,16703,10859,27562,23
kroB100.tsp,greedy-ls,random-walk,N1,96,22151,18001,40152,184
kroA100.tsp,greedy-ls,greedy-cycle,N1,34,11713,15934,27647,23
kroA100.tsp,greedy-ls,random-walk,N1,58,23815,20228,44043,163
kroB100.tsp,greedy-ls,greedy-cycle,N2,30,10624,15324,25948,19
kroA100.tsp,steepest-ls,random-walk,N1,46,17585,19580,37165,332
kroA100.tsp,greedy-ls,greedy-cycle,N2,32,14428,11657,26085,16
kroB100.tsp,greedy-ls,random-walk,N2,90,15993,13925,29918,151
kroB100.tsp,steepest-ls,greedy-cycle,N1,2,15054,10577,25631,45
kroB100.tsp,greedy-ls,greedy-cycle,N1,20,11027,15421,26448,25
kroA100.tsp,steepest-ls,random-walk,N2,56,13019,14150,27169,243
kroA100.tsp,greedy-ls,greedy-cycle,N1,22,15486,12386,27872,19
kroB100.tsp,greedy-ls,random-walk,N1,80,17705,21771,39476,161
kroA100.tsp,steepest-ls,random-walk,N1,11,23204,23638,46842,327
kroA100.tsp,steepest-ls,greedy-cycle,N1,93,12027,13870,25897,20
kroA100.tsp,greedy-ls,random-walk,N1,2,26201,20095,46296,200
kroB100.tsp,greedy-ls,greedy-cycle,N2,67,10099,16670,26769,18
kroB100.tsp,greedy-ls,greedy-cycle,N1,7,10837,16765,27602,11
kroB100.tsp,greedy-ls,random-walk,N2,28,14940,13029,27969,186
kroB100.tsp,greedy-ls,greedy-cycle,N2,88,15239,11907,27146,14
kroB100.tsp,steepest-ls,random-walk,N1,85,19687,19761,39448,350
kroA100.tsp,greedy-ls,greedy-cycle,N2,65,15198,12386,27584,14
kroA100.tsp,steepest-ls,greedy-cycle,N2,7,11713,14957,26670,47
kroA100.tsp,steepest-ls,greedy-cycle,N2,83,11713,14957,26670,46
kroB100.tsp,greedy-ls,random-walk,N1,38,19726,24581,44307,154
kroB100.tsp,greedy-ls,greedy-cycle,N1,77,14547,11867,26414,16
kroB100.tsp,steepest-ls,random-walk,N2,95,13528,14347,27875,235
kroB100.tsp,greedy-ls,greedy-cycle,N1,98,11220,15678,26898,17
kroA100.tsp,greedy-ls,greedy-cycle,N1,75,15198,12386,27584,17
kroA100.tsp,greedy-ls,random-walk,N1,19,19156,20365,39521,175
kroB100.tsp,steepest-ls,greedy-cycle,N2,51,14317,10353,24670,42
kroB100.tsp,greedy-ls,random-walk,N2,23,14435,13019,27454,163
kroB100.tsp,steepest-ls,random-walk,N1,61,27065,18130,45195,415
kroA100.tsp,greedy-ls,greedy-cycle,N2,81,11698,15798,27496,21
kroA100.tsp,steepest-ls,greedy-cycle,N1,98,14763,11657,26420,30
kroA100.tsp,greedy-ls,random-walk,N1,9,17864,22181,40045,198
kroA100.tsp,steepest-ls,greedy-cycle,N1,77,11915,15550,27465,34
kroB100.tsp,greedy-ls,greedy-cycle,N2,83,14317,10209,24526,14
kroB100.tsp,steepest-ls,greedy-cycle,N1,41,16692,10859,27551,40
kroB100.tsp,steepest-ls,random-walk,N2,71,14258,15039,29297,218
kroB100.tsp,greedy-ls,random-walk,N1,33,24488,26441,50929,179
kroA100.tsp,greedy-ls,greedy-cycle,N2,4,15198,12386,27584,18
kroA100.tsp,steepest-ls,greedy-cycle,N2,88,15486,12386,27872,36
kroA100.tsp,greedy-ls,greedy-cycle,N1,91,14770,11657,26427,15
kroA100.tsp,steepest-ls,greedy-cycle,N2,67,13353,12498,25851,36
kroB100.tsp,greedy-ls,greedy-cycle,N1,93,11108,15138,26246,17
kroA100.tsp,greedy-ls,random-walk,N1,12,17386,19232,36618,171
kroB100.tsp,greedy-ls,random-walk,N2,74,14482,13265,27747,143
kroB100.tsp,steepest-ls,random-walk,N1,36,21589,20478,42067,383
kroA100.tsp,greedy-ls,random-walk,N2,55,13760,13927,27687,173
kroA100.tsp,steepest-ls,greedy-cycle,N1,20,11713,15934,27647,35
kroA100.tsp,greedy-ls,greedy-cycle,N2,39,12333,14708,27041,29
kroB100.tsp,steepest-ls,greedy-cycle,N1,9,10827,16739,27566,16
kroB100.tsp,steepest-ls,random-walk,N2,26,14942,14230,29172,235
kroB100.tsp,greedy-ls,random-walk,N1,64,24851,17691,42542,193
kroB100.tsp,steepest-ls,greedy-cycle,N1,16,15576,11305,26881,40
kroA100.tsp,greedy-ls,random-walk,N1,45,24175,19292,43467,208
kroA100.tsp,greedy-ls,greedy-cycle,N1,29,12386,15198,27584,15
kroA100.tsp,steepest-ls,greedy-cycle,N2,30,12333,15083,27416,39
kroA100.tsp,steepest-ls,random-walk,N2,2,13200,12223,25423,260
kroB100.tsp,steepest-ls,greedy-cycle,N2,10,10896,15873,26769,41
kroB100.tsp,greedy-ls,random-walk,N2,62,14116,14902,29018,167
kroB100.tsp,steepest-ls,random-walk,N1,20,21292,20849,42141,256
kroA100.tsp,steepest-ls,greedy-cycle,N1,36,14581,11657,26238,25
kroA100.tsp,greedy-ls,random-walk,N2,43,12190,14437,26627,172
kroB100.tsp,steepest-ls,random-walk,N2,30,12514,15300,27814,253
kroB100.tsp,greedy-ls,random-walk,N1,72,20549,21807,42356,191
kroA100.tsp,steepest-ls,greedy-cycle,N2,26,15198,12386,27584,36
kroA100.tsp,greedy-ls,random-walk,N1,53,23698,19728,43426,152
kroA100.tsp,greedy-ls,greedy-cycle,N2,97,15198,12386,27584,15
kroB100.tsp,greedy-ls,random-walk,N2,35,13894,13241,27135,161
kroB100.tsp,steepest-ls,random-walk,N1,77,23366,23277,46643,299
kroB100.tsp,steepest-ls,greedy-cycle,N2,47,11505,16324,27829,46
kroA100.tsp,greedy-ls,random-walk,N2,14,13424,13605,27029,166
kroB100.tsp,steepest-ls,random-walk,N1,98,21917,20907,42824,305
kroB100.tsp,greedy-ls,greedy-cycle,N2,95,12068,15082,27150,27
kroA100.tsp,greedy-ls,greedy-cycle,N2,78,11502,14708,26210,22
kroA100.tsp,steepest-ls,greedy-cycle,N1,61,11698,15934,27632,39
kroA100.tsp,greedy-ls,greedy-cycle,N1,87,11414,14959,26373,18
kroB100.tsp,steepest-ls,random-walk,N2,67,14934,14007,28941,214
kroB100.tsp,greedy-ls,random-walk,N1,25,17817,18162,35979,183
kroB100.tsp,steepest-ls,greedy-cycle,N1,57,10827,16739,27566,16
kroB100.tsp,greedy-ls,greedy-cycle,N1,85,11134,15138,26272,13
kroB100.tsp,steepest-ls,random-walk,N2,88,13932,14321,28253,226
kroA100.tsp,steepest-ls,greedy-cycle,N2,71,12386,15198,27584,37
kroA100.tsp,greedy-ls,greedy-cycle,N1,68,11502,15434,26936,17
kroA100.tsp,steepest-ls,random-walk,N1,98,16731,20596,37327,397
kroA100.tsp,steepest-ls,random-walk,N1,77,22831,21994,44825,243
kroA100.tsp,greedy-ls,random-walk,N2,80,12484,14630,27114,165
kroA100.tsp,steepest-ls,random-walk,N2,88,13749,15432,29181,217
kroA100.tsp,steepest-ls,random-walk,N1,7,22429,21639,44068,279
kroA100.tsp,greedy-ls,greedy-cycle,N1,13,11657,14581,26238,14
kroB100.tsp,steepest-ls,random-walk,N1,5,21656,22296,43952,319
kroB100.tsp,greedy-ls,greedy-cycle,N1,11,11134,15138,26272,17
kroA100.tsp,steepest-ls,random-walk,N2,67,13451,13998,27449,235
kroA100.tsp,greedy-ls,random-walk,N1,90,24808,24533,49341,180
kroA100.tsp,greedy-ls,greedy-cycle,N2,54,11600,14119,25719,22
kroB100.tsp,steepest-ls,greedy-cycle,N2,84,10837,15384,26221,53
kroA100.tsp,greedy-ls,random-walk,N2,38,13571,14319,27890,164
kroA100.tsp,steepest-ls,random-walk,N1,20,16592,22662,39254,354
kroB100.tsp,greedy-ls,greedy-cycle,N2,56,10342,15390,25732,18
kroB100.tsp,greedy-ls,random-walk,N2,19,13964,15004,28968,178
kroA100.tsp,greedy-ls,greedy-cycle,N1,44,11600,14330,25930,20
kroB100.tsp,steepest-ls,greedy-cycle,N1,94,10827,16739,27566,17
kroA100.tsp,greedy-ls,random-walk,N1,28,19218,19950,39168,175
kroA100.tsp,steepest-ls,random-walk,N2,30,11624,13575,25199,236
kroB100.tsp,greedy-ls,greedy-cycle,N1,46,10827,16739,27566,9
kroA100.tsp,greedy-ls,greedy-cycle,N1,1,12532,12145,24677,26
kroB100.tsp,steepest-ls,greedy-cycle,N2,92,14206,11305,25511,44
kroA100.tsp,greedy-ls,greedy-cycle,N2,42,13485,12074,25559,21
kroB100.tsp,greedy-ls,greedy-cycle,N2,40,10153,16651,26804,8
kroA100.tsp,steepest-ls,random-walk,N1,36,22705,24415,47120,287
kroB100.tsp,greedy-ls,greedy-cycle,N2,9,10827,15813,26640,18
kroB100.tsp,steepest-ls,greedy-cycle,N1,82,14899,10763,25662,46
kroA100.tsp,greedy-ls,greedy-cycle,N1,52,11502,15434,26936,20
kroB100.tsp,greedy-ls,greedy-cycle,N1,50,15213,11807,27020,21
kroA100.tsp,steepest-ls,random-walk,N2,26,12696,13887,26583,236
kroA100.tsp,steepest-ls,greedy-cycle,N1,9,11713,15934,27647,44
kroA100.tsp,greedy-ls,greedy-cycle,N2,15,14435,11657,26092,18
kroA100.tsp,greedy-ls,random-walk,N2,79,13140,13971,27111,177
kroA100.tsp,greedy-ls,random-walk,N2,96,14385,12993,27378,163
kroA100.tsp,steepest-ls,random-walk,N1,61,27326,22133,49459,280
kroB100.tsp,greedy-ls,greedy-cycle,N2,17,16013,10859,26872,16
kroB100.tsp,greedy-ls,random-walk,N2,58,13891,14814,28705,166
kroA100.tsp,greedy-ls,random-walk,N1,69,21617,20872,42489,197
kroA100.tsp,greedy-ls,random-walk,N1,86,20843,20393,41236,175
kroA100.tsp,steepest-ls,random-walk,N2,71,14244,12348,26592,232
kroB100.tsp,greedy-ls,random-walk,N1,48,20726,24156,44882,175
kroA100.tsp,steepest-ls,greedy-cycle,N2,84,14435,11657,26092,37
kroB100.tsp,greedy-ls,greedy-cycle,N1,70,10342,16629,26971,18
kroA100.tsp,greedy-ls,greedy-cycle,N2,8,14813,12784,27597,16
kroB100.tsp,steepest-ls,random-walk,N2,92,14335,13594,27929,230
kroA100.tsp,greedy-ls,greedy-cycle,N1,72,14581,11657,26238,10
kroA100.tsp,greedy-ls,random-walk,N1,5,18117,22778,40895,172
kroA100.tsp,steepest-ls,greedy-cycle,N1,94,15486,12386,27872,41
kroB100.tsp,greedy-ls,greedy-cycle,N2,60,12359,13601,25960,27
kroA100.tsp,steepest-ls,random-walk,N1,16,18504,19983,38487,298
kroB100.tsp,steepest-ls,random-walk,N1,82,16501,17602,34103,384
kroA100.tsp,greedy-ls,greedy-cycle,N2,62,11869,15727,27596,12
kroA100.tsp,steepest-ls,random-walk,N2,51,13053,14080,27133,226
kroB100.tsp,greedy-ls,random-walk,N1,68,21104,25115,46219,184
kroB100.tsp,steepest-ls,greedy-cycle,N1,5,10288,16742,27030,26
kroB100.tsp,greedy-ls,greedy-cycle,N1,27,10827,16739,27566,12
kroA100.tsp,greedy-ls,greedy-cycle,N1,25,11830,16280,28110,21
kroB100.tsp,greedy-ls,random-walk,N1,87,21700,19103,40803,184
kroA100.tsp,greedy-ls,random-walk,N1,49,21679,23097,44776,198
kroA100.tsp,steepest-ls,random-walk,N1,41,25601,22198,47799,338
kroB100.tsp,greedy-ls,greedy-cycle,N2,37,10761,17105,27866,21
kroB100.tsp,greedy-ls,random-walk,N2,78,13719,15118,28837,165
kroA100.tsp,greedy-ls,greedy-cycle,N2,35,11669,15237,26906,18
kroB100.tsp,greedy-ls,random-walk,N2,97,12859,15784,28643,160
kroA100.tsp,greedy-ls,random-walk,N2,59,13580,14745,28325,149
kroB100.tsp,greedy-ls,greedy-cycle,N1,31,14408,11996,26404,24
kroA100.tsp,steepest-ls,random-walk,N2,47,14696,13202,27898,293
kroB100.tsp,greedy-ls,random-walk,N1,91,21436,22419,43855,184
kroA100.tsp,greedy-ls,greedy-cycle,N1,33,11657,14581,26238,12
kroA100.tsp,steepest-ls,greedy-cycle,N1,100,12386,15198,27584,45
kroB100.tsp,greedy-ls,greedy-cycle,N2,21,11648,14904,26552,20
kroA100.tsp,steepest-ls,random-walk,N1,57,21009,21694,42703,283
kroB100.tsp,greedy-ls,random-walk,N2,2,14045,14090,28135,158
kroB100.tsp,greedy-ls,random-walk,N2,81,14989,13171,28160,177
kroA100.tsp,greedy-ls,greedy-cycle,N2,23,14514,11657,26171,15
kroA100.tsp,steepest-ls,random-walk,N2,10,12947,13228,26175,229
kroB100.tsp,greedy-ls,random-walk,N1,29,18493,25627,44120,188
kroB100.tsp,greedy-ls,greedy-cycle,N1,66,12363,14284,26647,30
kroA100.tsp,steepest-ls,greedy-cycle,N2,92,11860,10969,22829,77
kroA100.tsp,greedy-ls,greedy-cycle,N1,64,11502,15415,26917,20
kroB100.tsp,steepest-ls,random-walk,N2,84,14670,12347,27017,242
kroB100.tsp,greedy-ls,greedy-cycle,N1,89,12440,14532,26972,30
kroB100.tsp,greedy-ls,greedy-cycle,N2,76,11194,14532,25726,21
kroB100.tsp,greedy-ls,random-walk,N2,39,13198,14536,27734,169
kroA100.tsp,steepest-ls,greedy-cycle,N1,82,11657,14581,26238,34
kroA100.tsp,greedy-ls,greedy-cycle,N2,74,14178,11657,25835,16
kroB100.tsp,greedy-ls,greedy-cycle,N2,99,11194,14445,25639,30
kroB100.tsp,steepest-ls,random-walk,N1,94,21641,20100,41741,331
kroA100.tsp,greedy-ls,random-walk,N2,18,13516,15027,28543,158
kroA100.tsp,steepest-ls,random-walk,N2,84,14122,13820,27942,234
kroA100.tsp,greedy-ls,random-walk,N1,73,20796,21592,42388,188
kroB100.tsp,steepest-ls,greedy-cycle,N1,20,11027,15534,26561,57
kroB100.tsp,greedy-ls,random-walk,N1,7,18944,22640,41584,178
kroB100.tsp,steepest-ls,random-walk,N2,10,14260,14175,28435,277
kroB100.tsp,greedy-ls,random-walk,N1,52,21852,18888,40740,149
kroB100.tsp,steepest-ls,random-walk,N1,9,22750,20700,43450,294
kroA100.tsp,steepest-ls,greedy-cycle,N1,16,15486,12386,27872,40
kroA100.tsp,steepest-ls,random-walk,N1,94,24003,26040,50043,315
kroA100.tsp,greedy-ls,random-walk,N2,63,12678,14455,27133,152
kroB100.tsp,steepest-ls,greedy-cycle,N2,30,10838,15443,26281,42
kroB100.tsp,greedy-ls,random-walk,N2,42,13782,16846,30628,145
kroA100.tsp,greedy-ls,random-walk,N1,24,20438,21918,42356,195
kroB100.tsp,steepest-ls,greedy-cycle,N1,98,11205,15678,26883,37
kroA100.tsp,steepest-ls,greedy-cycle,N2,51,11698,14957,26655,47
kroA100.tsp,greedy-ls,greedy-cycle,N1,48,12386,15198,27584,21
kroB100.tsp,steepest-ls,random-walk,N2,47,13071,14502,27573,273
kroB100.tsp,steepest-ls,greedy-cycle,N1,77,15576,11305,26881,41
kroA100.tsp,greedy-ls,random-walk,N2,34,13626,14259,27885,153
kroB100.tsp,steepest-ls,greedy-cycle,N2,88,14968,11907,26875,35
kroA100.tsp,greedy-ls,greedy-cycle,N2,58,11733,15306,27039,23
kroA100.tsp,steepest-ls,greedy-cycle,N1,41,12386,15198,27584,41
kroB100.tsp,greedy-ls,random-walk,N2,15,12841,15935,28776,160
kroB100.tsp,steepest-ls,random-walk,N1,57,20655,17798,38453,308
kroB100.tsp,steepest-ls,greedy-cycle,N2,67,10099,16651,26750,18
kroA100.tsp,steepest-ls,greedy-cycle,N2,47,14139,11657,25796,30
kroA100.tsp,greedy-ls,random-walk,N1,32,22753,21491,44244,187
kroB100.tsp,greedy-ls,greedy-cycle,N2,5,10099,16783,26882,12
kroA100.tsp,steepest-ls,greedy-cycle,N1,5,11502,15434,26936,38
kroB100.tsp,steepest-ls,greedy-cycle,N1,61,10827,16739,27566,17
kroB100.tsp,steepest-ls,random-walk,N2,51,16521,14567,31088,266
kroB100.tsp,greedy-ls,random-walk,N1,13,17557,20751,38308,160
kroA100.tsp,steepest-ls,greedy-cycle,N1,57,11713,15934,27647,35
kroA100.tsp,greedy-ls,random-walk,N2,22,13839,12963,26802,149
kroB100.tsp,steepest-ls,greedy-cycle,N2,71,11194,14354,25548,49
kroB100.tsp,steepest-ls,random-walk,N1,41,18315,16956,35271,326
kroA100.tsp,greedy-ls,random-walk,N1,65,21307,20088,41395,187
kroA100.tsp,steepest-ls,random-walk,N2,92,14926,12579,27505,208
kroA100.tsp,steepest-ls,greedy-cycle,N2,10,14147,11657,25804,38
kroB100.tsp,greedy-ls,random-walk,N1,44,23056,19908,42964,186
kroB100.tsp,steepest-ls,greedy-cycle,N1,36,16692,10859,27551,37
kroA100.tsp,greedy-ls,random-walk,N2,75,14449,17259,31708,171
kroA100.tsp,steepest-ls,random-walk,N1,82,22532,19974,42506,365
kroA100.tsp,greedy-ls,greedy-cycle,N2,19,15198,12386,27584,16
kroB100.tsp,greedy-ls,random-walk,N2,54,14614,15122,29736,157
kroB100.tsp,steepest-ls,random-walk,N1,16,21446,18582,40028,362
kroB100.tsp,steepest-ls,greedy-cycle,N2,26,10344,13876,24220,51
kroA100.tsp,greedy-ls,random-walk,N2,74,16620,13729,30349,173
kroB100.tsp,steepest-ls,greedy-cycle,N2,1,11506,14572,26078,51
kroA100.tsp,steepest-ls,random-walk,N1,83,19622,22249,41871,231
kroA100.tsp,greedy-ls,greedy-cycle,N2,18,14196,11657,25853,19
kroB100.tsp,greedy-ls,random-walk,N2,55,13631,13855,27486,162
kroB100.tsp,steepest-ls,random-walk,N1,17,22236,22046,44282,316
kroB100.tsp,steepest-ls,greedy-cycle,N2,27,10827,15415,26242,34
kroA100.tsp,greedy-ls,random-walk,N1,64,21244,21723,42967,216
kroA100.tsp,steepest-ls,random-walk,N2,93,13782,14936,28718,217
kroA100.tsp,steepest-ls,greedy-cycle,N2,11,14435,11657,26092,33
kroB100.tsp,greedy-ls,random-walk,N1,45,19370,16751,36121,169
kroB100.tsp,steepest-ls,greedy-cycle,N1,37,11316,17195,28511,40
kroA100.tsp,steepest-ls,greedy-cycle,N1,56,15198,12386,27584,43
kroA100.tsp,greedy-ls,random-walk,N2,23,15304,13398,28702,153
kroB100.tsp,steepest-ls,greedy-cycle,N2,70,10153,16651,26804,18
kroB100.tsp,steepest-ls,random-walk,N1,40,19054,27903,46957,349
kroA100.tsp,steepest-ls,greedy-cycle,N2,46,12386,15198,27584,36
kroA100.tsp,greedy-ls,random-walk,N2,1,15791,13924,29715,154
kroB100.tsp,greedy-ls,greedy-cycle,N2,4,14204,10209,24413,20
kroA100.tsp,greedy-ls,random-walk,N1,33,16819,19254,36073,205
kroA100.tsp,steepest-ls,greedy-cycle,N1,4,15198,12386,27584,46
kroB100.tsp,steepest-ls,greedy-cycle,N1,60,12450,13865,26315,66
kroB100.tsp,steepest-ls,random-walk,N2,50,13564,15052,28616,277
kroB100.tsp,greedy-ls,random-walk,N1,12,23553,20518,44071,148
kroA100.tsp,greedy-ls,random-walk,N2,35,14397,13282,27679,154
kroB100.tsp,steepest-ls,greedy-cycle,N2,89,12450,13601,26051,53
kroA100.tsp,steepest-ls,greedy-cycle,N1,40,11600,14330,25930,53
kroA100.tsp,greedy-ls,greedy-cycle,N2,59,14020,11657,25677,24
kroB100.tsp,greedy-ls,random-walk,N2,14,13041,15238,28279,166
kroB100.tsp,steepest-ls,random-walk,N1,56,20590,18184,38774,365
kroB100.tsp,steepest-ls,greedy-cycle,N2,66,12405,13081,25486,67
kroA100.tsp,greedy-ls,random-walk,N1,25,23587,15243,38830,164
kroB100.tsp,steepest-ls,greedy-cycle,N1,99,11205,15678,26883,33
kroA100.tsp,greedy-ls,greedy-cycle,N1,49,15513,12386,27899,16
kroA100.tsp,steepest-ls,greedy-cycle,N2,50,11502,14991,26493,40
kroB100.tsp,steepest-ls,random-walk,N2,46,13707,14134,27841,261
kroB100.tsp,steepest-ls,greedy-cycle,N1,76,11205,15678,26883,31
kroA100.tsp,steepest-ls,greedy-cycle,N1,17,14763,11657,26420,30
kroA100.tsp,steepest-ls,random-walk,N1,95,20523,21865,42388,349
kroA100.tsp,greedy-ls,random-walk,N2,62,14582,14750,29332,179
kroB100.tsp,steepest-ls,greedy-cycle,N2,31,14317,10353,24670,36
kroB100.tsp,greedy-ls,random-walk,N2,43,13877,14598,28475,157
kroA100.tsp,steepest-ls,random-walk,N2,85,15491,13349,28840,209
kroA100.tsp,greedy-ls,random-walk,N1,72,22004,20340,42344,184
kroB100.tsp,steepest-ls,greedy-cycle,N1,21,12212,15896,28108,39
kroB100.tsp,steepest-ls,random-walk,N2,11,14425,13063,27488,263
kroB100.tsp,greedy-ls,random-walk,N1,53,16302,20701,37003,174
kroB100.tsp,greedy-ls,random-walk,N1,6,24461,17193,41654,169
kroB100.tsp,steepest-ls,random-walk,N1,8,21697,18663,40360,254
kroA100.tsp,steepest-ls,random-walk,N1,100,23455,17668,41123,288
kroB100.tsp,greedy-ls,greedy-cycle,N2,77,14622,11222,25844,28
kroB100.tsp,greedy-ls,random-walk,N2,38,13793,14890,28683,157
kroA100.tsp,steepest-ls,greedy-cycle,N1,83,11713,15934,27647,41
kroA100.tsp,greedy-ls,greedy-cycle,N2,75,15198,12386,27584,17
kroB100.tsp,greedy-ls,greedy-cycle,N2,98,11194,14486,25680,21
kroB100.tsp,steepest-ls,random-walk,N1,95,21381,19859,41240,366
kroA100.tsp,greedy-ls,random-walk,N2,19,12996,12726,25722,159
kroA100.tsp,steepest-ls,random-walk,N2,11,15295,13072,28367,239
kroB100.tsp,greedy-ls,random-walk,N1,28,22623,19049,41672,186
kroB100.tsp,greedy-ls,greedy-cycle,N1,67,10575,16629,27204,20
kroA100.tsp,steepest-ls,greedy-cycle,N2,93,12016,13870,25886,17
kroA100.tsp,greedy-ls,greedy-cycle,N1,65,15198,12386,27584,16
kroB100.tsp,steepest-ls,random-walk,N2,85,13101,15398,28499,224
kroB100.tsp,greedy-ls,greedy-cycle,N1,88,15096,11751,26847,22
kroA100.tsp,greedy-ls,random-walk,N2,100,13299,14403,27702,176
kroB100.tsp,greedy-ls,greedy-cycle,N2,20,10693,15481,26174,22
kroA100.tsp,steepest-ls,random-walk,N1,56,20455,16943,37398,289
kroB100.tsp,greedy-ls,random-walk,N2,3,13330,14316,27646,168
kroB100.tsp,greedy-ls,random-walk,N2,80,14487,14643,29130,173
kroA100.tsp,greedy-ls,greedy-cycle,N2,22,15486,12386,27872,17
kroB100.tsp,greedy-ls,greedy-cycle,N1,30,11250,15415,26665,22
kroA100.tsp,steepest-ls,random-walk,N2,46,12853,12905,25758,273
kroB100.tsp,greedy-ls,random-walk,N1,90,26546,16516,43062,200
kroA100.tsp,greedy-ls,greedy-cycle,N1,32,14763,11657,26420,11
kroA100.tsp,steepest-ls,random-walk,N1,40,30593,18394,48987,300
kroB100.tsp,greedy-ls,greedy-cycle,N2,36,15657,10859,26516,29
kroB100.tsp,greedy-ls,random-walk,N2,79,14264,15279,29543,158
kroA100.tsp,greedy-ls,greedy-cycle,N2,34,11429,14257,25686,19
kroB100.tsp,greedy-ls,random-walk,N2,96,13804,14309,28113,170
kroA100.tsp,greedy-ls,random-walk,N2,58,14359,13409,27768,165
kroA100.tsp,steepest-ls,random-walk,N2,50,13347,12838,26185,223
kroB100.tsp,greedy-ls,random-walk,N1,69,17122,23526,40648,154
kroB100.tsp,steepest-ls,greedy-cycle,N1,4,14317,10763,25080,46
kroB100.tsp,greedy-ls,greedy-cycle,N1,26,10734,13854,24588,26
kroA100.tsp,greedy-ls,greedy-cycle,N1,24,14595,11657,26252,11
kroB100.tsp,greedy-ls,random-walk,N1,86,20801,17183,37984,171
kroA100.tsp,greedy-ls,random-walk,N1,48,19653,18423,38076,166
kroA100.tsp,greedy-ls,random-walk,N1,4,22382,21767,44149,163
kroA100.tsp,steepest-ls,greedy-cycle,N1,95,11657,14581,26238,28
kroB100.tsp,greedy-ls,greedy-cycle,N1,1,12238,16228,28466,15
kroB100.tsp,greedy-ls,greedy-cycle,N2,61,10827,15593,26420,22
kroA100.tsp,steepest-ls,random-walk,N1,17,20641,18771,39412,272
kroB100.tsp,steepest-ls,random-walk,N1,83,18445,19169,37614,322
kroA100.tsp,greedy-ls,greedy-cycle,N2,63,13943,11657,25600,13
kroA100.tsp,steepest-ls,greedy-cycle,N2,1,12532,10932,23464,57
kroA100.tsp,steepest-ls,greedy-cycle,N2,85,11502,14424,25926,52
kroB100.tsp,greedy-ls,greedy-cycle,N1,71,11194,15678,26872,14
kroA100.tsp,greedy-ls,greedy-cycle,N2,9,11929,15238,27167,18
kroB100.tsp,steepest-ls,random-walk,N2,93,14647,13919,28566,217
kroA100.tsp,greedy-ls,greedy-cycle,N1,73,11600,14330,25930,28
kroA100.tsp,greedy-ls,random-walk,N1,68,20658,19081,39739,238
kroA100.tsp,greedy-ls,random-walk,N1,87,14966,23346,38312,187
kroA100.tsp,steepest-ls,random-walk,N2,70,13402,13158,26560,249
kroB100.tsp,greedy-ls,random-walk,N1,49,19466,18815,38281,197
kroA100.tsp,greedy-ls,greedy-cycle,N2,14,12386,15198,27584,19
kroA100.tsp,greedy-ls,random-walk,N2,78,12388,13122,25510,176
kroA100.tsp,greedy-ls,random-walk,N2,97,13856,14456,28312,171
kroA100.tsp,steepest-ls,random-walk,N1,60,23056,19858,42914,335
kroB100.tsp,greedy-ls,greedy-cycle,N2,16,14883,11222,26105,19
kroB100.tsp,greedy-ls,random-walk,N2,59,14293,14771,29064,162
kroB100.tsp,greedy-ls,greedy-cycle,N2,8,11194,14532,25726,25
kroB100.tsp,steepest-ls,greedy-cycle,N1,83,14317,10763,25080,45
kroB100.tsp,steepest-ls,random-walk,N1,100,18428,23212,41640,419
kroA100.tsp,greedy-ls,greedy-cycle,N1,53,15486,12386,27872,14
kroB100.tsp,greedy-ls,greedy-cycle,N1,51,14408,10617,25025,29
kroA100.tsp,steepest-ls,random-walk,N2,27,15948,12912,28860,237
kroA100.tsp,steepest-ls,greedy-cycle,N1,8,14813,12784,27597,39
kroB100.tsp,steepest-ls,greedy-cycle,N2,93,11108,13814,24922,46
kroA100.tsp,greedy-ls,greedy-cycle,N2,43,12386,15198,27584,14
kroB100.tsp,greedy-ls,greedy-cycle,N2,41,16351,10859,27210,21
kroA100.tsp,steepest-ls,random-walk,N1,37,17944,20484,38428,312
kroA100.tsp,greedy-ls,greedy-cycle,N1,45,14575,11657,26232,17
kroB100.tsp,steepest-ls,greedy-cycle,N1,95,12212,15896,28108,39
kroA100.tsp,greedy-ls,random-walk,N1,29,27196,23116,50312,160
kroA100.tsp,steepest-ls,random-walk,N2,31,14071,11894,25965,235
kroB100.tsp,greedy-ls,greedy-cycle,N1,47,11533,16624,28157,22
kroA100.tsp,greedy-ls,greedy-cycle,N2,55,11713,14957,26670,19
kroB100.tsp,steepest-ls,greedy-cycle,N2,85,11108,13814,24922,48
kroA100.tsp,greedy-ls,random-walk,N2,39,14137,15868,30005,141
kroA100.tsp,steepest-ls,random-walk,N1,21,21550,22091,43641,283
kroB100.tsp,greedy-ls,greedy-cycle,N2,57,10827,15593,26420,20
kroB100.tsp,greedy-ls,random-walk,N2,18,13262,15253,28515,152
kroA100.tsp,steepest-ls,random-walk,N2,89,13417,13408,26825,218
kroA100.tsp,steepest-ls,random-walk,N1,6,22796,19194,41990,327
kroA100.tsp,greedy-ls,greedy-cycle,N1,12,11429,14959,26388,23
kroB100.tsp,steepest-ls,greedy-cycle,N1,100,10730,14227,24957,62
kroB100.tsp,steepest-ls,random-walk,N1,4,20994,20147,41141,246
kroB100.tsp,greedy-ls,greedy-cycle,N1,10,11909,16449,28358,17
kroA100.tsp,steepest-ls,random-walk,N2,66,13351,13446,26797,224
kroA100.tsp,greedy-ls,random-walk,N1,91,19268,17139,36407,196
kroA100.tsp,steepest-ls,random-walk,N1,99,21892,24063,45955,293
kroA100.tsp,steepest-ls,random-walk,N1,76,19078,16633,35711,318
kroA100.tsp,greedy-ls,random-walk,N2,81,14647,14405,29052,141
kroA100.tsp,greedy-ls,greedy-cycle,N1,86,11669,16156,27825,20
kroB100.tsp,steepest-ls,random-walk,N2,66,13492,15001,28493,228
kroB100.tsp,greedy-ls,random-walk,N1,24,20627,22473,43100,174
kroB100.tsp,steepest-ls,greedy-cycle,N1,56,10730,14227,24957,56
kroB100.tsp,greedy-ls,greedy-cycle,N1,84,10826,16765,27591,13
kroB100.tsp,steepest-ls,random-walk,N2,89,14858,14119,28977,228
kroA100.tsp,greedy-ls,greedy-cycle,N1,69,11600,14330,25930,22
kroA100.tsp,steepest-ls,greedy-cycle,N2,70,15486,12386,27872,36
kroA100.tsp,greedy-ls,greedy-cycle,N2,96,11538,13893,25431,33
kroB100.tsp,greedy-ls,random-walk,N2,34,13702,13698,27400,175
kroB100.tsp,steepest-ls,random-walk,N1,76,20989,20986,41975,350
kroB100.tsp,steepest-ls,greedy-cycle,N2,46,10827,15415,26242,33
kroA100.tsp,greedy-ls,random-walk,N2,15,13365,13604,26969,168
kroB100.tsp,steepest-ls,random-walk,N1,99,19331,21485,40816,328
kroB100.tsp,greedy-ls,greedy-cycle,N2,94,10827,15593,26420,17
kroA100.tsp,steepest-ls,greedy-cycle,N1,60,11915,15550,27465,32
kroA100.tsp,greedy-ls,greedy-cycle,N2,79,15489,12386,27875,17
kroB100.tsp,steepest-ls,random-walk,N2,31,14211,16042,30253,218
kroB100.tsp,greedy-ls,random-walk,N1,73,23453,16621,40074,158
kroA100.tsp,steepest-ls,greedy-cycle,N2,27,11713,14957,26670,45
kroA100.tsp,greedy-ls,random-walk,N1,52,19177,21789,40966,180
kroA100.tsp,steepest-ls,random-walk,N2,3,14581,15842,30423,249
kroB100.tsp,steepest-ls,greedy-cycle,N2,11,11108,13814,24922,43
kroB100.tsp,greedy-ls,random-walk,N2,63,14817,14742,29559,186
kroB100.tsp,steepest-ls,random-walk,N1,21,20671,16896,37567,406
kroA100.tsp,steepest-ls,greedy-cycle,N1,37,11502,15434,26936,40
kroB100.tsp,steepest-ls,random-walk,N2,1,15144,14399,29543,250
kroA100.tsp,greedy-ls,random-walk,N2,42,13266,12923,26189,172
kroB100.tsp,steepest-ls,greedy-cycle,N1,8,11205,15678,26883,35
kroB100.tsp,steepest-ls,random-walk,N2,27,13571,14395,27966,241
kroB100.tsp,greedy-ls,random-walk,N1,65,27732,22058,49790,148
kroB100.tsp,steepest-ls,greedy-cycle,N1,17,16692,10859,27551,51
kroA100.tsp,greedy-ls,random-walk,N1,44,20752,21309,42061,166
kroA100.tsp,steepest-ls,greedy-cycle,N2,31,11860,10969,22829,70
kroA100.tsp,greedy-ls,greedy-cycle,N1,28,13148,12688,25836,18
kroB100.tsp,greedy-ls,random-walk,N2,75,12849,15238,28087,166
kroB100.tsp,steepest-ls,random-walk,N1,37,23464,20567,44031,348
kroA100.tsp,greedy-ls,random-walk,N2,54,13304,13325,26629,175
kroA100.tsp,greedy-ls,greedy-cycle,N2,38,14435,11657,26092,15
kroA100.tsp,steepest-ls,greedy-cycle,N1,21,14581,11657,26238,31
kroB100.tsp,steepest-ls,greedy-cycle,N1,40,10342,16742,27084,32
kroA100.tsp,greedy-ls,greedy-cycle,N2,5,11600,13654,25254,26
kroB100.tsp,steepest-ls,random-walk,N2,70,14907,14188,29095,221
kroB100.tsp,greedy-ls,random-walk,N1,32,19073,23865,42938,186
kroA100.tsp,greedy-ls,greedy-cycle,N1,90,15513,12386,27899,16
kroA100.tsp,steepest-ls,greedy-cycle,N2,89,11860,10969,22829,72
kroA100.tsp,steepest-ls,greedy-cycle,N2,66,15198,12386,27584,37
kroB100.tsp,greedy-ls,greedy-cycle,N1,92,15684,11867,27551,18
kroA100.tsp,greedy-ls,random-walk,N1,13,20332,19107,39439,176
kroB100.tsp,steepest-ls,greedy-cycle,N2,50,14988,11807,26795,38
kroB100.tsp,greedy-ls,random-walk,N2,22,13844,13121,26965,165
kroB100.tsp,steepest-ls,random-walk,N1,60,20391,20092,40483,445
kroA100.tsp,steepest-ls,greedy-cycle,N1,99,14581,11657,26238,30
kroA100.tsp,greedy-ls,greedy-cycle,N2,80,13485,12074,25559,21
kroA100.tsp,greedy-ls,random-walk,N1,8,17668,19482,37150,195
kroA100.tsp,steepest-ls,greedy-cycle,N1,76,11657,14581,26238,30
kroB100.tsp,greedy-ls,greedy-cycle,N2,82,14765,10353,25118,24
